
der Weg = путь
der Monat = месяц
das Mal = раз
die Musik = музыка
das Bild = картина, изображение
das Tier = животное
die Sache = вещь, дело
die Schule = школа
das Unternehmen = предприятие
der Kunde = клиент
die Art = вид
das Jahrhundert = век
die Region = регион
der Freund = друг
die Zukunft = будущее
der Platz = место
der Spaß = удовольствие
die Grenze = граница
das Team = команда
der Anfang = начало
das Gefühl = чувство
der Raum = пространство
der Besucher = посетитель
das Ding = вещь
die Firma = фирма
die Hand = рука
der Kilometer = километр
der Moment = момент
die Angst = страх
die Natur = природа
der Grund = причина
das Stück = кусок, часть
die Herausforderung = вызов
der Kopf = голова
die Seite = сторона
das Thema = тема
der Gast = гость
das Ziel = цель
die Form = форма
das Projekt = проект
die Wohnung = квартира
der Baum = дерево
die Eltern = родители
die Mutter = мать
die Tradition = традиция
der Krieg = война
die Kunst = искусство
das Dorf = деревня
das Museum = музей
das Fleisch = мясо
die Frage = вопрос
der zweite = второй
der Berg = гора
der Job = работа
der Vater = отец
die Minute = минута
der Mitarbeiter = сотрудник
der Winter = зима
die Erfahrung = опыт
die Heimat = родина
die Technik = техника
der Grad = градус
der Künstler = художник
der Markt = рынок
der Tourist = турист
die Energie = энергия
das Foto = фото
die Richtung = направление
der Blick = взгляд
das Buch = книга
die Möglichkeit = возможность
der Name = имя
der Alltag = повседневная жизнь
das Geschäft = бизнес, магазин
die Hilfe = помощь
der Preis = цена
das Produkt = продукт
das Restaurant = ресторан
das Schloss = замок
der Schüler = ученик
die USA = США
die Ukraine = Украина
das Video = видео
das Licht = свет
der Sport = спорт
die Situation = ситуация
die Uhr = часы
das Bier = пиво
das Gebäude = здание
das Jahrzehnt = десятилетие
die Nähe = близость
die Person = человек
der Schweizer = швейцарец
der Wald = лес
die Farbe = цвет
das Glück = счастье
die Menge = количество
die Rolle = роль
die Gruppe = группа
die Hauptstadt = столица
der Kollege = коллега
der Traum = мечта
der Boden = земля, пол
die Chance = шанс
die Figur = фигура
das Holz = дерево
der Punkt = точка, пункт
die Regel = правило
das Auge = глаз
die Gesellschaft = общество
die Höhe = высота
das Medium = средство
die Politik = политика
der Sinn = смысл
die Tonne = тонна
der Wiener = вьеннец
der Zug = поезд
die Ausstellung = выставка
die Marke = марка
der Schnee = снег
die Sprache = язык
die Alpen = Альпы
das Brot = хлеб
das Internet = интернет
die Miete = аренда
die Mitte = середина
die Nacht = ночь
das Schiff = корабль
die Weise = способ
die Information = информация
der Bereich = область
der Bewohner = житель
der Dom = собор
das Eis = лед
das Fahrzeug = транспортное средство
die Kirche = церковь
die Kultur = культура
das Modell = модель
das Netz = сеть
die Reise = путешествие
die Schweiz = Швейцария
der Strom = электричество, поток
der Beruf = профессия
der König = король
die Regierung = правительство
die Stelle = место
der Trend = тренд
die Aufgabe = задача
der Betrieb = предприятие
der Bus = автобус
das Gericht = суд
das Material = материал
die Ruhe = покой
der Schritt = шаг
die Studie = исследование
der Arzt = врач
die Bevölkerung = население
die Bewegung = движение
die Bühne = сцена
der Einsatz = использование, вмешательство
der Einwohner = житель
die Hälfte = половина
die Landschaft = пейзаж
die Meinung = мнение
die Pandemie = пандемия
die Pause = пауза
der Sommer = лето
die Türkei = Турция
die App = приложение
der Beton = бетон
das Datum = дата
der Druck = давление
die Entscheidung = решение
die Erde = земля
der Erfolg = успех
der Fisch = рыба
die Folge = следствие, серия
der Geschmack = вкус
das Instrument = инструмент
der Kontakt = контакт
die Lösung = решение
das Muss = необходимость
die Produktion = производство
das Schnitzel = шницель
das Fenster = окно
der Film = фильм
das Gesicht = лицо
der Lehrer = учитель
die Liebe = любовь
das Spiel = игра
das Werk = произведение, работа
die Ausbildung = образование
das Bauwerk = сооружение
der Chef = начальник
der Döner = вертел, шаурма
der Fan = фанат
das Hotel = отель
die Kamera = камера
die Kuh = корова
die Küche = кухня
die Leidenschaft = страсть
die Pflanze = растение
der Sohn = сын
die Sorge = забота
der Spargel = спаржа
der Star = звезда
der Wert = значение, стоимость
der Westen = запад
das Wort = слово
die Zahl = число
die Anlage = установка, объект
die Behörde = орган, ведомство
die Brücke = мост
die Entwicklung = развитие
der Herr = господин
das Herz = сердце
die Karriere = карьера
das Kilo = килограмм
die Milch = молоко
die Milliarde = миллиард
der Morgen = утро
der Vorteil = преимущество
das Zentrum = центр
das Zuhause = дом
das Essen = еда
der Experte = эксперт
das Fahrrad = велосипед
die Fahrt = поездка
der Fuß = нога
das Gesetz = закон
die Größe = размер
die Maschine = машина
die Mode = мода
die Polizei = полиция
der Schutz = защита
der Stoff = ткань, материал
die Tour = тур
die Wahl = выбор
der Weihnachtsbaum = рождественская ёлка
der Bau = строительство
die Branche = отрасль
der Bruder = брат
der Club = клуб
das Dach = крыша
das Ergebnis = результат
der Körper = тело
der Landwirt = фермер
das Lebensmittel = продукт питания
das Meer = море
das Motiv = мотив
der Nachbar = сосед
die Qualität = качество
die Strecke = расстояние, маршрут
das System = система
der Tisch = стол
der Unterschied = разница
die Verbindung = связь
das Vorbild = пример
der Wunsch = желание
die Zutat = ингредиент
der Bauer = фермер
der Besuch = визит
die Botschaft = посольство
die Freiheit = свобода
die Gefahr = опасность
das Konzept = концепция
das Kostüm = костюм
die Luft = воздух
der Mieter = арендатор
die Moschee = мечеть
das Mädchen = девочка
der Norden = север
der Park = парк
die Pizza = пицца
die Schokolade = шоколад
die Show = шоу
der Staat = государство
der Stein = камень
die Stimme = голос
der Tourismus = туризм
der Urlaub = отпуск
der Weihnachtsmann = Дед Мороз
der Weltkrieg = мировая война
das Alter = возраст
das Angebot = предложение
der Auftrag = заказ
das Handy = мобильный телефон
das Insekt = насекомое
der Kauf = покупка
die Kosten = затраты
das Model = модель
der Musiker = музыкант
die Plattform = платформа
der Protest = протест
der Quadratmeter = квадратный метр
das Recht = право
das Rezept = рецепт
der Schuh = обувь
die Spur = след
der Tanz = танец
der Ton = звук
das Tor = ворота
das Training = тренировка
die Umwelt = окружающая среда
der Vergleich = сравнение
das Wetter = погода
die Architektur = архитектура
der Auftritt = выступление
der Brite = британец
das Büro = офис
das Erlebnis = переживание
die Flasche = бутылка
das Gegenteil = противоположность
das Geheimnis = секрет
die Insel = остров
das Interesse = интерес
die Lage = расположение
die Leistung = производительность, достижение
die Masse = масса
der Nationalpark = национальный парк
der Patient = пациент
der Roman = роман
der Salat = салат
die Seele = душа
der Song = песня
die Steuer = налог
die Unterstützung = поддержка
das Zimmer = комната
die Alternative = альтернатива
die Altstadt = старый город
die Antwort = ответ
die Behinderung = инвалидность
die Brezel = крендель
der Bürger = гражданин
der Computer = компьютер
das Detail = деталь
das Element = элемент
der Engel = ангел
das Feld = поле
die Fläche = площадь
der Gedanke = мысль
das Gemüse = овощи
das Gespräch = разговор
das Handwerk = ремесло
die Industrie = промышленность
die Kraft = сила
der Käse = сыр
der Laden = магазин
der Liter = литр
die Mauer = стена
die Nachfrage = спрос
die Nummer = номер
der Passagier = пассажир
das Patent = патент
der Plan = план
das Ruhrgebiet = Рурская область
die Schwester = сестра
der See = озеро
die Sicherheit = безопасность
das Umfeld = окружение
der Unterricht = занятие
das Virus = вирус
der Wanderer = путешественник
der Wasserstoff = водород
die Werkstatt = мастерская
der Abend = вечер
der Arbeitsplatz = рабочее место
der Architekt = архитектор
der Brandenburger = брандебургец
der Brief = письмо
der Designer = дизайнер
das Fest = праздник
das Feuer = огонь
der Flughafen = аэропорт
der Garten = сад
der Golf = гольф
die Haut = кожа
der Inhalt = содержание
der Karneval = карнаваль
das Klima = климат
das Konzert = концерт
die Krise = кризис
die Maske = маска
die Oberfläche = поверхность
das Paar = пара
der Partner = партнёр
der Politiker = политик
der Rohstoff = сырьё
die Runde = круг
das Schwein = свинья
der Stress = стресс
der Student = студент
der Teilnehmer = участник
der Test = тест
die Tochter = дочь
die Tür = дверь
die Variante = вариант
die Vielfalt = разнообразие
der Walzer = вальс
die Wand = стена
die Wolle = шерсть
die Wurzel = корень
das Alphorn = альпийский рог
das Ausland = заграница
das Bett = кровать
die Börse = биржа
die DDR = ГДР
die Erfindung = изобретение
das Flugzeug = самолёт
das Gas = газ
die Gegend = местность
das Geräusch = шум
die Großstadt = крупный город
der Junge = мальчик
die Kleidung = одежда
das Kunstwerk = произведение искусства
der Kölner = колонец
der Lauf = бег
der Lebkuchen = пряник
der Motor = мотор
der Mut = мужество
die Möbel = мебель
die Niederlande = Нидерланды
das Phänomen = феномен
der Rest = остаток
das Salz = соль
die Sicht = вид
die Szene = сцена
der Süden = юг
die Temperatur = температура
der Tunnel = туннель
der Verein = клуб
die Verfügung = распоряжение
die Wirtschaft = экономика
das Bein = нога
das Blatt = лист
die Bäckerei = пекарня
die Currywurst = колбаса с карри
das Dirndl = традиционное платье
die Ecke = угол
der Eindruck = впечатление
die Erinnerung = воспоминание
der Fehler = ошибка
der Flüchtling = беженец
die Fotografie = фотография
die Gemeinde = община
die Gesundheit = здоровье
das Glas = стекло
der Glühwein = глинтвейн
das Haar = волос
der Hintergrund = фон
das Hobby = хобби
die Hoffnung = надежда
der Händler = торговец
der Impfstoff = вакцина
der Kaiser = император
der Kampf = борьба
das Kilogramm = килограмм
die Klasse = класс
die Kohle = уголь, деньги
das Krankenhaus = больница
die Krankheit = болезнь
der Kurs = курс
die Lust = желание
das Mitglied = член (организации)
das Mittel = средство
das Objekt = объект
die Partei = партия
das Prinzip = принцип
das Publikum = публика
die Realität = реальность
die Ressource = ресурс
die Sammlung = коллекция
das Schweden = Швеция
die Sekunde = секунда
das Smartphone = смартфон
die Spende = пожертвование
das Stroh = солома
das Studium = учёба
die Technologie = технология
die Verantwortung = ответственность
der Verkehr = движение, транспорт
das Vorurteil = предвзятое мнение
die Ware = товар
die Welle = волна
die Werbung = реклама
der Wind = ветер
der Wissenschaftler = учёный
das Wochenende = выходные
der Wolf = волк
der Zucker = сахар
der Abstand = расстояние
das Album = альбом
der Alkohol = алкоголь
die Aussicht = вид, перспектива
die Band = группа, лента
die Basis = база
die Bedingung = условие
das Bewusstsein = сознание
das Bord = борт
die Burg = замок
der Cent = цент
der Dank = благодарность
der Dollar = доллар
das Drittel = треть
das Ei = яйцо
der Fahrer = водитель
der Finger = палец
die Freude = радость
das Geschenk = подарок
der Hersteller = производитель
die Herstellung = производство
der Hof = двор
die Institution = учреждение
die KI (Künstliche Intelligenz) = искусственный интеллект
der Kaugummi = жевательная резинка
der King = король
der Klang = звук
der Klimawandel = изменение климата
die Lehrerin = учительница
der Look = внешний вид
der Mythos = миф
das Oktoberfest = Октоберфест
das Original = оригинал
der Post = почта
das Risiko = риск
der Rücken = спина
der Schaden = ущерб
der Schnitt = разрез, порез
der Schwarzwald = Шварцвальд
das Ski = лыжа
der Stil = стиль
das Studio = студия
das Symbol = символ
der Teig = тесто
der Tod = смерть
die Umfrage = опрос
der Umsatz = оборот
der Ursprung = происхождение
das Viertel = квартал, четверть
die Vorstellung = представление
der Wagen = автомобиль, повозка
das Wahrzeichen = достопримечательность
der Weihnachtsmarkt = рождественский рынок
der Wein = вино
die Agentur = агентство
der Arbeitgeber = работодатель
die Bahn = железная дорога
der Bahnhof = вокзал
die Baustelle = строительный объект
das Bulgarien = Болгария
der Bundestag = Бундестаг
das Dia = слайд
der Durchschnitt = среднее значение
die EU = Европейский Союз
der Effekt = эффект
das Erbe = наследство
der Februar = февраль
der Flug = рейс, полет
die Forschung = исследование
das Frankfurt = Франкфурт
die Gemeinschaft = сообщество
das Grundeinkommen = базовый доход
die Haltung = позиция, отношение
der Hamburger = гамбургер
der Handwerker = ремесленник, рабочий
die Heimatstadt = родной город
die Identität = идентичность
die Innenstadt = центр города
der Kanal = канал
der Kebab = кебаб
die Kollektion = коллекция
der Krebs = рак
die Lokomotive = локомотив
die Macht = власть
das Mehl = мука
der Müll = мусор
die Nachricht = сообщение, новость
der Oldtimer = старинный автомобиль
der Pariser = парижанин
die Party = вечеринка
das Programm = программа
der Rock = юбка, рок
die Schicht = смена
die Spezialität = специальность
die Sportart = вид спорта
die Spree = Шпрее (река)
der Start = старт
die Suche = поиск
das Tal = долина
der Teller = тарелка
der Termin = встреча, срок
der Turm = башня
der Tänzer = танцор
der User = пользователь
der VW = Фольксваген
die Vergangenheit = прошлое
der Verkauf = продажа
die Veränderung = изменение
der Volkswagen = Фольксваген
die Weihnachtsgurke = рождественский огурец
das Wohnzimmer = гостиная
die Zeichnung = рисунок
der Zirkus = цирк
der Zustand = состояние
der Abgeordnete = депутат
der Bekannte = знакомый
das Abenteuer = приключение
die Anerkennung = признание
die Armee = армия
der Artikel = статья, артикул
die Auswirkung = воздействие
die Bank = банк, скамейка
der Bauch = живот
der Beginn = начало
der Beitrag = вклад
die Belastung = нагрузка
die Beziehung = отношение
der Bezug = ссылка, отношение
die Blüte = цветок, расцвет
die Brauerei = пивоварня
das Bundesland = федеральная земля
der Bürgermeister = мэр
die Community = сообщество
das Design = дизайн
die Diagnose = диагноз
der Diesel = дизель
die Ehre = честь
die Emotion = эмоция
das Ensemble = ансамбль
der Esel = осел
das Experiment = эксперимент
der Follower = подписчик
die Freundschaft = дружба
die Fähigkeit = способность
das Gebiet = территория
das Gerät = устройство
das Getreide = зерно
die Gewalt = насилие
der Handel = торговля
die Initiative = инициатива
die Inspiration = вдохновение
der Investor = инвестор
der Keller = подвал
der Kredit = кредит
das Kreuzfahrtschiff = круизный лайнер
die Kugel = шар
die Kulisse = декорация
der Käufer = покупатель
der Köhler = угольщик
die Landwirtschaft = сельское хозяйство
der Lohn = зарплата
der Müller = мельник
der Oktober = октябрь
der Pist = пистолет (обычно "die Pistole")
der Planet = планета
die Pommes = картофель фри
der Rattenfänger = крысолов
der Reichstag = Рейхстаг
die Reihe = ряд
der Rhein = Рейн
der Sand = песок
der Schluss = конец
die Schwierigkeit = трудность
die Schönheit = красота
das Social = социальный
die Spitze = вершина
die Staatsbürgerschaft = гражданство
die Station = станция
die Stiftung = фонд
die Stimmung = настроение
der Supermarkt = супермаркет
der Trainer = тренер
der Verbraucher = потребитель
die Version = версия
das Volk = народ
die Vorbereitung = подготовка
der West = Запад
die Wildkräuter = дикие травы
das Wunder = чудо
die Wärme = тепло
das Zeichen = знак
der Zufall = случай
der Zuschauer = зритель
die Ahnung = предчувствие
der Anteil = доля
der Arbeitnehmer = работник
die Aufmerksamkeit = внимание
die Aufnahme = запись, прием
der Ausflug = поездка
die Autobahn = автомагистраль
der Autor = автор
der Ball = мяч
die Bedeutung = значение
der Bunker = бункер
die Butter = масло
der Charakter = характер
die Diversität = разнообразие
das Dutzend = дюжина
die Ebene = уровень
die Fashion = мода
die Fassade = фасад
der Forscher = исследователь
der Franzose = француз
das Frühstück = завтрак
das Gefängnis = тюрьма
das Gehalt = зарплата
das Gehirn = мозг
das Gewicht = вес
der Gletscher = ледник
das Gold = золото
der Großteil = большая часть
der Großvater = дедушка
das Gut = добро, имущество
die Handarbeit = ручная работа
das Highlight = кульминация
der Himmel = небо
der Holzmarkt = рынок древесины
die Innovation = инновация
die Intelligenz = интеллект
der Juli = июль
die Kartoffel = картофель
die Katastrophe = катастрофа
die Kindheit = детство
der Klassiker = классика
der Kontinent = континент
die Koralle = коралл
der Kranich = журавль
die Kräuter = травы
das Kurzem = недавнее время
der Mauerfall = падение стены
die Maßnahme = мера, мероприятие
das Mittelalter = средневековье
das Münster = монастырь
das Ohr = ухо
die Oma = бабушка
das Opfer = жертва
die Option = опция
der Ost = Восток
das Papier = бумага
die Perspektive = перспектива
das Preußen = Пруссия
der Rassismus = расизм
der Respekt = уважение
die Schneekugel = снежный шар
die Schulter = плечо
das Spanien = Испания
der Spieler = игрок
der Stadtteil = район города
der Strand = пляж
die Struktur = структура
der Tipp = совет
der Titel = титул
der Trick = трюк
die Tänzerin = танцовщица
die Universität = университет
die Veranstaltung = мероприятие
das Verkehrsmittel = транспортное средство
der Versuch = попытка
das Wachstum = рост
das Weingut = винодельня
der Weizen = пшеница
das Werkzeug = инструмент
der Wettbewerb = соревнование
der Zoo = зоопарк
der Angestellte = служащий
die Aktion = акция
der Antrieb = привод, стимул
die Anzahl = количество
der Apfelstrudel = яблочный штрудель
der April = апрель
der Arbeiter = рабочий
das Atelier = ателье
der Ausblick = вид
das Baujahr = год постройки
der Bayer = баварец
der Besitzer = владелец
das Brandenburg = Бранденбург
das Brotbier = хлебное пиво
der Bäcker = пекарь
das Chaos = хаос
der Chinese = китаец
das Christkind = Рождественское дитя
die Demokratie = демократия
das Eiweiß = белок
die Emission = выброс
die Etage = этаж
der Fahrgast = пассажир
die Faszination = увлечение
die Flucht = побег
der Fokus = фокус
der Fortschritt = прогресс
der Fotograf = фотограф
die Freizeit = свободное время
der Fund = находка
der Fußball = футбол
die Galerie = галерея
der Geburtstag = день рождения
der Gegner = соперник
die Gelegenheit = возможность
das Gewürz = специя
der Hafen = порт
die Hast = спешка
der Haushalt = домохозяйство
die Haustür = входная дверь
der Hund = собака
das Immunsystem = иммунная система
das Island = Исландия
der Jakobsweg = путь Святого Иакова
der Journalist = журналист
der Kaffee = кофе
die Kasse = касса
die Kinderarbeit = детский труд
das Kino = кино
der Klotz = брусок, кусок
die Konkurrenz = конкуренция
der Konzern = концерн
die Kälte = холод
das Label = этикетка, бренд
der Ladepunkt = зарядная станция
der Lebensraum = жизненное пространство
das Leder = кожа
die Linie = линия
der Macher = деятель
die Media = медиа
der Migrant = мигрант