bei = у, при
da = там, потому что
nach = в (направление)
um = вокруг, около
vor = перед
einfach = просто
mal = раз
kein = никакой
mein = мой
doch = всё же, однако
viel = много
wieder = снова
über = над, о
wer = кто
weil = потому что
bis = до
neu = новый
heute = сегодня
natürlich = естественно
uns = нас, нам
unser = наш
denn = потому что, так как; именно
aller = весь, все
mir = мне
wirklich = действительно
eigentlich = на самом деле
durch = через
seit = начиная с
deutsch = немецкий
wo = где
damit = для того чтобы; с этим
mich = меня
klein = маленький
alt = старый
wichtig = важный
eben = как раз, именно
erst = сначала, только
etwas = что-то
rund = круглый
sondern = а, но
halt = просто, ведь
dafür = за это, для этого
selbst = сам
schön = красивый
ohne = без
du = ты
dabei = при этом, с этим
unter = под
vielleicht = возможно
gerade = прямо, только что
weniger = меньше
hoch = высокий
drei = три
richtig = правильный
lang = длинный
gar = совсем
fast = почти
ob = ли
weit = далеко
dazu = к этому, для этого
schnell = быстрый
genau = точный
sogar = даже
jung = молодой
weiter = дальше
nie = никогда
ab = от, с
nichts = ничего
dort = там
einmal = один раз
weltweit = всемирный
ihnen = им
oft = часто
vier = четыре
besonders = особенно
ein bisschen = немного
irgendwie = каким-то образом
zurück = назад
Europa = Европа
davon = от этого
einiger = некоторый
gegen = против
schwer = тяжёлый
zusammen = вместе
spät = поздний
anders = другой
beide = оба
ihm = ему
deshalb = поэтому
echt = настоящий
fünf = пять
gleich = такой же, сразу
pro = за (единицу)
stark = сильный
tatsächlich = фактически
warum = почему
solcher = такой
zehn = десять
früh = ранний
manchmal = иногда
überhaupt = вообще
etwa = примерно
mancher = некоторый
ein paar = пара
zwischen = между
bereits = уже
kaum = едва
klar = ясный
lang = длинный
ne = не (разговорное)
bissch = немного (сокращение от „ein bisschen”)
deswegen = поэтому
toll = классный
schwierig = трудный
nun = теперь
deutsch = немецкий
sogenannter = так называемый
zwar = хотя
damals = тогда
darauf = на это
selber = сам
welcher = какой
verschieden = различный
gerne = с удовольствием
sonst = иначе
trotzdem = всё равно
euch = вас
leicht = лёгкий
möglich = возможный
während = во время
mittlerweile = тем временем
allein = один
dadurch = благодаря этому
eher = скорее
am = на (сокращение от „an dem”)
unterwegs = в пути
wenig = мало
wohl = хорошо, вероятно
fertig = готовый
darüber = об этом
direkt = прямой
komplett = полный
her = сюда, отсюда
sechs = шесть
rein = чистый
sicher = безопасный
überall = везде
hinter = за
kurz = короткий
voll = полный
je = когда-либо
oben = наверху
sozusagen = так сказать
wegen = из-за
allerdings = однако
beliebt = популярный
daran = к этому
extrem = экстремальный
gemeinsam = совместный
insgesamt = в целом
modern = современный
teuer = дорогой
okay = хорошо
darum = поэтому
einzig = единственный
bekannt = известный
besonder = особенный
international = международный
normal = нормальный
hin = туда
jemand = кто-то
statt = вместо
raus = наружу
ziemlich = довольно
alle = все
bestimmt = определённый
europäisch = европейский
irgendwann = когда-нибудь
knapp = недостаточно, не хватает, мало, короткий
los = старт, исчезнуть
mehrere = несколько
quasi = как бы
schlecht = плохой
inzwischen = тем временем
digital = цифровой
persönlich = личный
berühmt = знаменитый
bevor = до того как
drin = внутри
egal = всё равно
gleichzeitig = одновременно
neben = рядом
sieben = семь
vorher = до этого
bald = скоро
einige = несколько
irgendwo = где-то
offen = открытый
ungefähr = примерно
aktuell = актуальный
genauso = точно так же
sozial = социальный
vergangen = прошедший
zumindest = по крайней мере
öffentlich = общественный
draußen = снаружи
erfolgreich = успешный
frisch = свежий
laut = громкий
perfekt = идеальный
selten = редкий
traditionell = традиционный
bisher = до сих пор
daraus = из этого
deutlich = ясный, четкий
dir = тебе
gern = охотно
relativ = относительно
täglich = ежедневный
China = Китай
acht = восемь
hart = трудный
klassisch = классический
nein = нет
weg = путь, исчезнувший
dich = тебя
gesamt = общий
wahrscheinlich = вероятно
alleine = один
bayerisch = баварский
daher = оттуда, поэтому
danach = после этого
fest = твердый
genug = достаточно
schließlich = наконец
sofort = немедленно
vorbei = мимо
zusätzlich = дополнительный
eng = узкий
miteinander = вместе
nah = близкий
regelmäßig = регулярный
absolut = абсолютный
außerdem = кроме того
nachhaltig = устойчивый
neun = девять
obwohl = хотя
riesig = гигантский
tief = глубокий
total = полный
unterschiedlich = различный
völlig = совершенно
Gott = Бог
Venedig = Венеция
Wien = Вена
aufgrund = на основании
drauf = на это (разговорное)
ehemalig = бывший
halb = половина
Paris = Париж
langsam = медленный
mindestens = по крайней мере
na = ну
niemand = никто
politisch = политический
zunächst = сначала
bereit = готовый
besonders = особенно
gewiss = определённый, уверенный
meist = в основном
meistens = чаще всего
mitten = в середине
neu = новый
seitdem = с тех пор
speziell = специальный
bitte = пожалуйста
dagegen = против
darunter = под этим
einst = однажды
gefährlich = опасный
grün = зелёный
heutzutage = в наше время
innerhalb = внутри
plötzlich = внезапно
stolz = гордый
technisch = технический
unglaublich = невероятный
wahr = истинный
einzeln = отдельный
entsprechend = соответствующий
historisch = исторический
häufig = частый
leider = к сожалению
längst = давно
möglichst = насколько возможно
teilweise = частично
trotz = несмотря на
typisch = типичный
britisch = британский
ganz = целый
lieb = милый
lieber = более милый, лучше (в сравнении)
nachdem = после того как
privat = частный
schwarz = чёрный
ähnlich = похожий
Frankreich = Франция
bunt = разноцветный
derzeit = в настоящее время
ehrlich = честный
endlich = наконец
interessant = интересный
per = через
weiß = белый
Bayern = Бавария
Hallo = привет
München = Мюнхен
Russland = Россия
Weihnachten = Рождество
dritter = третий
gering = незначительный
momentan = в данный момент
normalerweise = обычно
positiv = позитивный
praktisch = практичный
russisch = русский
ständig = постоянный
Österreich = Австрия
Corona = корона, коронавирус
Deutsch = немецкий
bewusst = осознанный
französisch = французский
glücklich = счастливый
günstig = выгодный, удобный
spannend = захватывающий
wunderbar = чудесный
zwölf = двенадцать
Italien = Италия
super = супер
eins = один
global = глобальный
offiziell = официальный
streng = строгий
tausend = тысяча
türkisch = турецкий
vegan = веганский
wesentlich = существенный
wirtschaftlich = экономический
zahlreich = многочисленный
Tausend = тысяча
begeistert = воодушевленный
davor = до этого
dein = твой
dran = на это (разговорное)
faszinierend = захватывающий
hierher = сюда
kalt = холодный
morgens = по утрам
nämlich = а именно
unbedingt = обязательно
warm = тёплый
weiterhin = продолжать
zuerst = сначала
Belgien = Бельгия
Großbritannien = Великобритания
aktiv = активный
entfernt = удалённый
irgendwas = что-то
jedoch = однако
jährlich = ежегодный
schlimm = плохой
Asien = Азия
Indien = Индия
Polen = Польша
hinten = сзади
hinterher = после этого, следом
jugendliche = молодёжный
lustig = весёлый
nahe = близкий
nötig = необходимый
rot = красный
super = супер
ukrainisch = украинский
unabhängig = независимый
unten = внизу
verantwortlich = ответственный
wann = когда
zweimal = дважды
übrig = оставшийся
abends = по вечерам
beispielsweise = например
dahinter = за этим
definitiv = определённо
einzigartig = уникальный
falsch = неправильный
fein = изысканный
froh = радостный
heraus = наружу
kreativ = креативный
sicherlich = наверняка
vermutlich = вероятно
verrückt = сумасшедший
zuvor = ранее
österreichisch = австрийский
Celsius = Цельсий
ausschließlich = исключительно
chinesisch = китайский
darin = в этом
derselbe = тот же самый
desto = тем
durchaus = вполне
heimisch = местный
niederländisch = нидерландский
nördlich = северный
professionell = профессиональный
tot = мёртвый
weder = ни
wär = был бы
übrigens = кстати
Hamburg = Гамбург
nee = нет
anstrengend = утомительный
außen = снаружи
beruflich = профессионально
billig = дешевый
bislang = до сих пор
dennoch = тем не менее
drinnen = внутри
ernst = серьёзный
früher = раньше
gegenüber = напротив
gemütlich = уютный
heutig = современный
irgendein = какой-то
nachts = ночью
ungewöhnlich = необычный
virtuell = виртуальный
wunderschön = великолепный
zuständig = ответственный
cool = крутой
online = онлайн
anschließend = затем
ansonsten = в остальном
außerhalb = за пределами
belgisch = бельгийский
circa = примерно
dahin = туда
entscheidend = решающий
extra = дополнительный
gesund = здоровый
krank = больной
langfristig = долгосрочный
letztendlich = в конечном итоге
links = слева
nebenan = рядом
niedrig = низкий
niemals = никогда
ruhig = спокойный
sauber = чистый
scharf = острый
selbstverständlich = само собой разумеется
sichtbar = видимый
süß = сладкий
trocken = сухой
vorne = спереди
öfter = чаще
Brasilien = Бразилия
Indonesien = Индонезия
Köln = Кёльн
analog = аналогичный
anderthalb = полтора
aufmerksam = внимательный
dank = благодаря
derjenige = тот, кто
elf = одиннадцать
entweder = либо
heiß = горячий
hinaus = наружу
hundert = сто
immerhin = всё же
interessiert = заинтересованный
leer = пустой
magisch = магический
maximal = максимальный
mobil = мобильный
passend = подходящий
real = реальный
recht = правый, правильный
reich = богатый
runter = вниз
schön = красивый
sodass = так что
ursprünglich = первоначальный
wertvoll = ценный
zukünftig = будущий
Afrika = Африка
einfach = простой
Japan = Япония
Leipzig = Лейпциг
Pakistan = Пакистан
Potsdam = Потсдам
beeindruckend = впечатляющий
erstmal = сначала
erwachsen = взрослый
ewig = вечный
genügend = достаточный
indem = путём того, что
innen = внутри
insbesondere = особенно
insofern = в той степени
kaputt = сломанный
offensichtlich = очевидный
sowohl = как … так и
spanisch = испанский
treu = верный
vorhanden = существующий
wert = ценность
wiederum = в свою очередь
willkommen = приветствуемый
Düsseldorf = Дюссельдорф
Grönland = Гренландия
arm = бедный
aufregend = захватывающий
automatisch = автоматический
außergewöhnlich = исключительный
blau = синий
bloß = просто
diverser = разнообразный
doppelt = двойной
drüber = сверху
dunkel = тёмный
durchschnittlich = средний
dünn = тонкий
effizient = эффективный
einheimisch = местный
elektrisch = электрический
fantastisch = фантастический
finanziell = финансовый
gestern = вчера
gigantisch = гигантский
grundsätzlich = принципиальный
hauptsächlich = основной
herkömmlich = традиционный
hinein = внутрь
hinzu = к
hochwertig = высококачественный
hoffentlich = надеюсь
ideal = идеальный
irgendwelcher = какой-то
italienisch = итальянский
jahrelang = годами
kompliziert = сложный
künftig = будущий
künstlich = искусственный
lebend = живой
lecker = вкусный
letztlich = в конечном итоге
olympisch = олимпийский
regional = региональный
sportlich = спортивный
umso = тем более
weich = мягкий
zentral = центральный
ökologisch = экологический
hey = привет
breit = широкий
dankbar = благодарный
dauerhaft = постоянный
dick = толстый
diesmal = на этот раз
ebenfalls = также
ebenso = так же
einerseits = с одной стороны
enorm = огромный
erneuerbar = возобновляемый
exklusiv = эксклюзивный
freiwillig = добровольный
geheim = секретный
geil = классный, крутой
gewaltig = огромный
großartig = великолепный
grün = зелёный
herum = вокруг
jedenfalls = в любом случае
mehrfach = многократный
mutig = смелый
nachher = после
nix = ничего
polnisch = польский
ran = к
schade = жаль
sowieso = всё равно
traurig = грустный
unmöglich = невозможный
von = от
vorsichtig = осторожный
wachsend = растущий
wahnsinnig = сумасшедший
wenigstens = по крайней мере
zugleich = одновременно
jung = молодой