gegeben = давать
kommen — ist gekommen = приходить
gehen — ist gegangen = идти
wollen — ich/er will — wollte = хочу
sagen — gesagt = сказать
sehen — er sieht — gesehen = видеть
sollen — ich/er soll — sollte — sollte = обязан
müssen — ich/er muss — musste — müsste = нужно
finden — gefunden = находить
stehen — gestanden = стоять
wissen — gewusst = знать
arbeiten — gearbeitet = работать
nehmen — er nimmt — genommen = брать
denken an {Akk.} — gedacht = думать о
bekommen — bekommen = получать
bleiben — ist geblieben = оставаться
heißen — geheißen = называться
liegen — gelegen = лежать
zeigen — gezeigt = показывать
glauben an {Akk.} — geglaubt = верить в
brauchen — gebraucht = нуждаться
tun — getan = делать
schaffen — geschafft = справляться, создавать
dürfen — ich/er darf — durfte — dürfte = разрешать / возможность — сесть, помочь, курить, идти
möchten — ich/er möchte = хотел бы (would like)
bauen — gebaut = строить
gehören zu {Dat.} — gehört = принадлежать к
lassen — er lässt — gelassen = позволять
fahren — er fährt — ist gefahren = ехать
bringen — gebracht = приносить
haben — er hat — gehabt = иметь
versuchen — versucht = пытаться
spielen — gespielt = играть
kennen — gekannt = знать
entstehen — ist entstanden = возникать
halten — er hält — gehalten = держать
setzen {sich} — gesetzt = садиться; {ставить, помещать}
stellen — gestellt = ставить, задавать (вопрос)
führen — geführt = вести
treffen {sich} — er trifft — getroffen = встречать, {встречаться}
sprechen — er spricht — gesprochen = говорить
helfen — er hilft — geholfen = помогать
verkaufen — verkauft = продавать
fühlen {sich} — gefühlt = чувствовать что-то {чувствовать себя}
entwickeln {sich} — entwickelt = развивать что-то {развиваться}
nutzen — genutzt = использовать
erleben — erlebt = переживать
essen — er isst — gegessen = есть
beginnen — begonnen = начинать
suchensuchen nach {Akk.} — gesucht = искать
ziehen — gezogen = тянуть, переезжать
passieren — ist passiert = происходить
erreichen — erreicht = достигать
kaufen — gekauft = покупать
laufen — er läuft — ist gelaufen = бегать, идти
produzieren — produziert = производить
verändern {sich} — verändert = изменять что-то {изменяться}
gelten — gegolten = считаться
fallen — er fällt — ist gefallen = падать
sitzen — ist gesessen = сидеть
fragen — gefragt = спрашивать
schauen — geschaut = смотреть
sorgen für {Akk.} — gesorgt = заботиться о
bewegen {sich} — bewegt = двигать что-то; {двигаться}
bieten — geboten = предлагать
kosten — gekostet = стоить
tragen — er trägt — getragen = носить
herstellen — hergestellt = производить
lieben — geliebt = любить
steigen — ist gestiegen = подниматься
dauern — gedauert = длиться
hören — gehört = слышать
meinen — gemeint = думать, считать
merken — gemerkt = замечать
aussehen — ausgesehen = выглядеть
verlieren — verloren = терять
verstehen — verstanden = понимать
erzählen — erzählt = рассказывать
mögen — ich/er mag — mochte = нравится (like, ≠ would like)
erkennen — erkannt = узнавать
nennen — genannt = называть
kriegen — gekriegt = получать
wachsen — ist gewachsen = расти
verbinden — verbunden = соединять
freuen {sich} über / auf {Akk.} — gefreut = радовать; {радоваться / предстоящему}
gucken — geguckt = смотреть
schreiben — geschrieben = писать
stecken — gesteckt = вставлять, находиться
wohnen — gewohnt = жить
erhalten — erhalten = получать
genießen — genossen = наслаждаться
kämpfen — gekämpft = бороться
tanzen — getanzt = танцевать
bedeuten — bedeutet = значить
entdecken — entdeckt = обнаруживать
ändern — geändert = изменять
bezahlen — bezahlt = платить
fehlen — gefehlt = отсутствовать
gewinnen — gewonnen = выигрывать
hoffen auf {Akk.} — gehofft = надеяться на
stammen — gestammt = происходить
holen — geholt = получать, приносить
kümmern sich — gekümmert = заботиться
reichen — gereicht = хватать, быть достаточным
scheinen — geschienen = казаться
schützen — geschützt = защищать
vorstellen sich — vorgestellt = представляться
warten auf {Akk.} — gewartet = ждать чего-либо
anfangen — angefangen = начинать
passen zu {Dat.} — gepasst = подходить к
schmecken — geschmeckt = вкусить, быть вкусным
wirken — gewirkt = действовать
wünschen — gewünscht = желать
bestehen — bestanden = состоять, существовать
zahlen — gezahlt = платить
lassen — er lässt — gelassen = позволять
schließen — geschlossen = закрывать, заключать
drehen — gedreht = крутить, вертеть
entscheiden — entschieden = решать
schlagen — geschlagen = бить
betreiben — betrieben = заниматься (чем-то)
erfahren — erfahren = узнавать, испытывать
feiern — gefeiert = праздновать
lesen — er liest — gelesen = читать
verlassen — er verlässt — verlassen = покидать
beobachten — beobachtet = наблюдать
erklären — erklärt = объяснять
gelingen — gelungen = удаваться
gründen — gegründet = основывать
legen — gelegt = класть
sagen — gesagt = говорить
erinnern {sich} an {Akk.} — erinnert = напоминать о; {помнить о}
hängen — gehangen = висеть
liefern — geliefert = доставлять
unterstützen — unterstützt = поддерживать
zerstören — zerstört = разрушать
leiten — geleitet = руководить
spüren — gespürt = ощущать
umgehen — umgegangen = обходиться
verwenden — verwendet = использовать
vorbereiten — vorbereitet = готовить
zählen — gezählt = считать
übernehmen — übernommen = брать на себя
ankommen — ist angekommen = прибывать
backen — gebacken = печь
klingen — geklungen = звучать
leisten — geleistet = оказывать, выполнять
planen — geplant = планировать
reden — geredet = говорить
starten — gestartet = стартовать
sterben — er stirbt — ist gestorben = умирать
treten — getreten = ступать, наступать
überlegen — überlegt = обдумывать
beschäftigen — beschäftigt = заниматься
öffnen — geöffnet = открывать
anschauen — angeschaut = смотреть
besuchen — besucht = посещать
sammeln — gesammelt = собирать
testen — getestet = тестировать
erfinden — erfunden = изобретать
fangen — gefangen = ловить
fliegen — ist geflogen = лететь
fotografieren — fotografiert = фотографировать
gebären — geboren = рожать
handeln — gehandelt = действовать
rufen — gerufen = звать
stattfinden — stattgefunden = происходить
teilen — geteilt = делиться
vergessen — er vergisst — vergessen = забывать
vermitteln — vermittelt = передавать
aufbauen — aufgebaut = строить, создавать
entfernen — entfernt = удалять
eröffnen — eröffnet = открывать
studieren — studiert = учиться
verbringen — verbracht = проводить
überzeugen — überzeugt = убеждать
bestimmen — bestimmt = определять
folgen — gefolgt = следовать
reagieren auf {Akk.} — reagiert = реагировать на
retten — gerettet = спасать
trinken — getrunken = пить
bilden — gebildet = формировать
erwarten — erwartet = ожидать
finden — gefunden = находить
fällen — gefällt = рубить, сбрасывать
gestalten — gestaltet = оформлять
interessieren für {Akk.} — interessiert = интересоваться чем-либо
investieren — investiert = инвестировать
gelöst = решать
organisieren — organisiert = организовывать
probieren — probiert = пробовать
verarbeiten — verarbeitet = перерабатывать
verbessern — verbessert = улучшать
anbieten — angeboten = предлагать
bereiten — vorbereitet = готовить
betreffen — betroffen = касаться
einsetzen — eingesetzt = использовать
erzeugen — erzeugt = производить
landen — gelandet = приземляться
stimmen — gestimmt = быть верным, голосовать
verteilen — verteilt = распределять
wählen — gewählt = выбирать
überleben — überlebt = выживать
aufwachsen — ist aufgewachsen = расти
füllen — gefüllt = заполнять
greifen — gegriffen = хватать
kennenlernen — kennengelernt = знакомиться
lohnen — gelohnt = стоить
profitieren — profitiert = извлекать выгоду
sparen — gespart = экономить
verschwinden — ist verschwunden = исчезать
wandern — ist gewandert = ходить пешком
wechseln — gewechselt = менять
üben — geübt = упражняться
aufnehmen — aufgenommen = принимать, записывать
sich befinden — sich befunden = находиться
entwerfen — entworfen = разрабатывать
fordern — gefordert = требовать
integrieren — integriert = интегрировать
mitnehmen — mitgenommen = брать с собой
rauchen — geraucht = курить
schlafen — er schläft — geschlafen = спать
schätzen — geschätzt = оценивать
vertrauen — vertraut = доверять
ausprobieren — ausprobiert = пробовать
bedrohen — bedroht = угрожать
dienen — gedient = служить
inspirieren — inspiriert = вдохновлять
rechnen — gerechnet = считать
schicken — geschickt = отправлять
stoßen — gestoßen = толкать, наталкиваться
verbieten — verboten = запрещать
verhindern — verhindert = предотвращать
begeistern — begeistert = вдохновлять
begleiten — begleitet = сопровождать
brechen — er bricht — gebrochen = ломать
ersetzen — ersetzt = заменять
festhalten — festgehalten = держаться, сохранять
feststellen — festgestellt = устанавливать
heben — gehoben = поднимать
klappen — geklappt = получаться, складываться
kochen — gekocht = готовить
kreieren — kreiert = создавать
leiden — gelitten = страдать
servieren — serviert = подавать (еду)
trainieren — trainiert = тренироваться
versorgen — versorgt = обеспечивать
warnen — gewarnt = предупреждать
anlegen — angelegt = вкладывать
bestellen — bestellt = заказывать
kontrollieren — kontrolliert = контролировать
malen — gemalt = рисовать
mischen — gemischt = смешивать
präsentieren — präsentiert = представлять
reduzieren — reduziert = уменьшать
singen — gesungen = петь
verfolgen — verfolgt = следить
verzichten — verzichtet = отказываться
angehen — angegangen = касаться, затрагивать
aufgeben — aufgegeben = сдаваться, прекращать
aufstellen — aufgestellt = устанавливать
beibringen — beigebracht = научить
beitragen — beigetragen = способствовать
benutzen — benutzt = использовать
erforschen — erforscht = исследовать
errichten — errichtet = сооружать
herrschen — geherrscht = господствовать
motivieren — motiviert = мотивировать
mussten — gemusst = должны были
scheitern — gescheitert = потерпеть неудачу
transportieren — transportiert = транспортировать
treiben — getrieben = заниматься (чем-либо), гнать
veröffentlichen — veröffentlicht = публиковать
achten — geachtet = обращать внимание
bearbeiten — bearbeitet = обрабатывать
behaupten — behauptet = утверждать
benötigen — benötigt = нуждаться
dokumentieren — dokumentiert = документировать
einstellen — eingestellt = настраивать, прекращать
entspannen — entspannt = расслабляться
ermöglichen — ermöglicht = позволять
faszinieren — fasziniert = очаровывать
fertigen — gefertigt = изготавливать
fliehen — ist geflohen = убегать
fürchten — gefürchtet = бояться
geraten — geraten = попадать
gewöhnen — gewöhnt = привыкать
konzentrieren sich — konzentriert = концентрироваться
laden — geladen = загружать
mitmachen — mitgemacht = принимать участие
reisen — gereist = путешествовать
rennen — ist gerannt = бегать
schneiden — geschnitten = резать
stören — gestört = беспокоить
trauen — getraut = доверять
träumen von {Dat.} — geträumt = мечтать о
verletzen — verletzt = ранить
werfen — er wirft — geworfen = бросать
zeichnen — gezeichnet = рисовать
überraschen — überrascht = удивлять
anpassen sich — angepasst = адаптироваться
austauschen — ausgetauscht = обменивать
bedienen — bedient = обслуживать
beeindrucken — beeindruckt = впечатлять
beeinflussen — beeinflusst = влиять
behalten — behalten = сохранять
berühren — berührt = трогать
beweisen — bewiesen = доказывать
diskutieren — diskutiert = обсуждать
exportieren — exportiert = экспортировать
herkommen — gekommen = происходить, быть родом
recyceln — recycelt = перерабатывать
schwimmen — geschwommen = плавать
umsetzen — umgesetzt = осуществлять
verwandeln — verwandelt = превращать
wahrnehmen — wahrgenommen = воспринимать
weitergehen — weitergegangen = продолжать
ansagen — angesagt = объявлять
ansehen — angesehen = смотреть
anziehen — angezogen = надевать
aussterben — ausgestorben = вымирать
behandeln — behandelt = лечить, обращаться
beziehen — bezogen = получать, относиться
buchen — gebucht = бронировать
eingehen — eingegangen = вступать (в контакт), умирать
empfinden — empfunden = ощущать
erfüllen — erfüllt = исполнять
ergeben — ergeben = составлять, оказываться
erledigen — erledigt = выполнять
erschaffen — erschaffen = создавать
fördern — gefördert = способствовать
gelangen — gelangt = достигать
haben — er hat — gehabt = иметь
herausfinden — herausgefunden = выяснять
kleben — geklebt = клеить
lenken — gelenkt = управлять
schießen — geschossen = стрелять
sichern — gesichert = обеспечивать
sinken — gesenkt = снижаться
trennen — getrennt = разделять
unterscheiden — unterschieden = различать
verbreiten — verbreitet = распространять
vereinen — vereint = объединять
vertreiben — vertrieben = изгнать
widmen — gewidmet = посвящать
abbauen — abgebaut = разбирать, добывать
ausgehen — ausgegangen = выходить
auskommen — ausgekommen = обходиться
ausstatten — ausgestattet = оснащать
beschreiben — beschrieben = описывать
besetzen — besetzt = занимать
beteiligen — beteiligt = участвовать
betrachten — betrachtet = рассматривать
brennen — gebrannt = гореть
darstellen — dargestellt = изображать
einladen — eingeladen = приглашать
enden — geendet = заканчиваться
enthalten — enthalten = содержать
entsorgen — entsorgt = утилизировать
erkunden — erkundet = исследовать
erlauben — erlaubt = разрешать
erscheinen — erschienen = появляться
finanzieren — finanziert = финансировать
kehren — gekehrt = мести
melden — gemeldet = сообщать
nachdenken — nachgedacht = размышлять
nähen — genäht = шить
reinigen — gereinigt = чистить
richten — gerichtet = направлять
senken — gesenkt = опускать
unterrichten — unterrichtet = преподавать
verdanken — verdankt = быть обязанным
verhalten — verhalten = вести себя
übersetzen — übersetzt = переводить