aller = всякий / любой  
die Bar — Bars = бар  
die Droge — Drogen = наркотик  
englisch = английский  
golden = золотой  
lokal = местный  
das Netzwerk — Netzwerke = сеть  
die Quelle — Quellen = источник  
das Sagen = власть / право голоса  
staatlich = государственный  
die Union — Unionen = союз  
die Analyse — Analysen = анализ  
der Ansatz — Ansätze = подход / метод  
ausländisch = иностранный  
je = каждый / по (в зависимости от контекста)  
jüdisch = еврейский  
die Abstimmung — Abstimmungen = голосование  
der Akteur — Akteure = деятель / участник  
der Aussichtspunkt — Aussichtspunkte = смотровая площадка  
der Bund — Bünde = федерация / союз  
die Einreise = въезд  
die Führung — Führungen = руководство / экскурсия  
die Investition — Investitionen = инвестиция  
die Nutzung = использование  
die Regelung — Regelungen = регулирование / правило  
das Verbot — Verbote = запрет  
auswärtig = иностранный / внешний  
spannend = захватывающий  
umstritten = спорный  
der Beamte — Beamten = чиновник  
der Betreiber — Betreiber = оператор / владелец  
der Demonstrant — Demonstranten = демонстрант  
die Festnahme — Festnahmen = задержание  
der Klimaschutz = защита климата  
die Korruption = коррупция  
die Legende — Legenden = легенда  
die Metropole — Metropolen = мегаполис  
die Strategie — Strategien = стратегия  
allgemein = общий  
bedeutend = значительный  
dominieren — dominiert = доминировать  
einreisen — reist ein — ist eingereist — reiste ein = въезжать  
festnehmen — nimmt fest — festgenommen — nahm fest = арестовывать  
geplant = запланированный  
identifizieren — identifiziert = идентифицировать  
kriminell = преступный  
lebendig = живой  
sicherstellen — stellt sicher — sichergestellt = обеспечивать / гарантировать  
verdächtig = подозрительный  
verkünden — verkündet = объявлять  
die Wirkung — Wirkungen = эффект / воздействие  
das Wohlergehen = благополучие  
das Wohnhaus — Wohnhäuser = жилой дом  
der Wähler — Wähler = избиратель  
der Zauber = магия / волшебство  
die Zielgruppe — Zielgruppen = целевая аудитория  
der Zins — Zinsen = процент (на капитал)  
der Zusammenhalt = сплочённость  
abwarten — abgewartet = выжидать  
agieren — agiert = действовать  
alkoholisch = алкогольный  
allgegenwärtig = повсеместный  
allmählich = постепенно  
angespannt = напряжённый  
anonym = анонимный  
anreisen — reist an — ist angereist = приезжать  
anschließen — schließt an — angeschlossen — schloss an = присоединять  
anweisen — weist an — angewiesen — wies an = инструктировать  
auffangen — fängt auf — aufgefangen — fing auf = ловить / подхватывать  
auftauchen — taucht auf — ist aufgetaucht = появляться  
auftreten — tritt auf — ist aufgetreten — trat auf = выступать / возникать  
aufwendig = затратный  
ausarbeiten — arbeitet aus — ausgearbeitet = разрабатывать  
ausbleiben — bleibt aus — ist ausgeblieben — blieb aus = отсутствовать  
autonom = автономный  
begeben sich — begibt — begeben — begab = отправляться  
bekräftigen — bekräftigt = подтверждать  
belebt = оживлённый  
beleuchten — beleuchtet = освещать  
bergen — birgt — geborgen — barg = спасать / укрывать  
beruhen auf { Dativ } — beruht = основываться на { чём? }  
beschränken — beschränkt — beschränkte = ограничивать  
besitzen — besessen — besaß = владеть  
bestreiten — bestritten — bestritt = оспаривать  
beteiligt = вовлечённый  
betroffen = затронутый  
betrügen — betrogen — betrog = обманывать  
bewerten — bewertet = оценивать  
bezweifeln — bezweifelt — bezweifelte = сомневаться  
binden — gebunden — band = связывать  
blockieren — blockiert = блокировать  
blühen — geblüht = цвести  
boomen — geboomt = процветать  
brauen — gebraut = варить (пиво)  
brutal = жестокий  
charmant = обаятельный  
detailliert = детальный  
deuten — gedeutet = толковать / интерпретировать  
diagnostizieren — diagnostiziert = диагностировать  
durchsetzen — setzt durch — durchgesetzt = проводить / добиваться  
durchsuchen — durchsucht = обыскивать  
düster = мрачный  
eignen sich — geeignet = подходить  
eindämmen — dämmt ein — eingedämmt = сдерживать / ограничивать  
einschätzen — schätzt ein — eingeschätzt = оценивать  
einstufen — stuft ein — eingestuft = классифицировать  
elitär = элитарный  
erachten — erachtet = считать / рассматривать  
erlassen — erlässt — erlassen — erließ = издавать (указ)  
erneuern — erneuert = обновлять  
exportieren — exportiert = экспортировать  
farbenfroh = яркий / красочный  
forschen — geforscht = исследовать  
fremd = чужой / иностранный  
geflochten = плетёный  
gefragt = востребованный  
gegrillt = жареный на гриле  
gelegen = расположенный / удобный  
gerecht = справедливый  
gestiegen = увеличившийся  
gewohnt = привычный  
grundlegend = фундаментальный  
hilfreich = полезный  
hinweisen auf { Akkusativ } — weist hin — hingewiesen — wies hin = указывать на { что? }  
hölzern = деревянный  
inspirierend = вдохновляющий  
klonen — klont — geklont = клонировать  
kommunistisch = коммунистический  
konfrontieren — konfrontiert = противостоять  
konkret = конкретный  
königlich = королевский  
künstlerisch = художественный  
langwierig = длительный  
legal = легальный  
lehnen sich — gelehnt = прислоняться  
leistungsfähig = продуктивный  
locker = свободный / расслабленный  
lockern — gelockert = ослаблять  
lukrativ = прибыльный  
luxuriös = роскошный  
meiden — gemieden — mied = избегать  
mild = мягкий  
militärisch = военный  
nachkommen { Dativ } — kommt nach — ist nachgekommen — kam nach = выполнять / следовать { чему? }  
neigen zu { Dativ } — geneigt = склоняться к { чему? }  
organisiert = организованный  
orientieren sich an { Dativ } — orientiert = ориентироваться на { что? }  
pflegen — gepflegt = ухаживать  
polizeilich = полицейский  
posten — gepostet = публиковать (в соцсетях)  
präsent = присутствующий  
psychologisch = психологический  
rasant = стремительный  
religiös = религиозный  
sarkastisch = саркастический  
schimmernd = мерцающий  
schroff = резкий / грубый  
schrumpfen — ist geschrumpft = сокращаться / уменьшаться  
schwärmen von { Dativ } — geschwärmt = восторгаться { чем? }  
siedeln — gesiedelt = заселять  
sozialistisch = социалистический  
spektakulär = впечатляющий  
steigend = возрастающий  
stocken — gestockt = задерживаться / останавливаться  
strömen — ist geströmt = течь / устремляться  
stylisch = стильный  
suspendieren — suspendiert = отстранять  
synthetisch = синтетический  
tödlich = смертельный  
umgeben — umgibt — umgeben — umgab = окружать  
umwandeln — wandelt um — umgewandelt = преобразовывать  
unangenehm = неприятный  
unbequem = неудобный  
unerlässlich = необходимый  
unmittelbar = непосредственный  
unterbringen — bringt unter — untergebracht — brachte unter = размещать  
unterteilen — unterteilt = подразделять  
untrennbar = неразрывный  
unwahrscheinlich = маловероятный  
verantwortlich = ответственный  
verbreitet = распространённый  
verbrennen — verbrannt — verbrannte = сжигать  
verfallen — verfällt — ist verfallen — verfiel = разрушаться / приходить в упадок  
verfassen — verfasst = составлять / писать  
verhandeln — verhandelt = вести переговоры  
verhören — verhört = допрашивать  
verlässlich = надёжный  
vernünftig = разумный  
versagen — versagt = терпеть неудачу  
versammeln sich — versammelt = собираться  
verstärkt = усиленный  
vertreten — vertritt — vertreten — vertrat = представлять / заменять  
vielfach = многократный  
vollkommen = совершенный  
vorlegen — legt vor — vorgelegt = предъявлять  
vorsehen — sieht vor — vorgesehen — sah vor = предусматривать  
vorwerfen — wirft vor — vorgeworfen — warf vor = упрекать  
wandeln — ist gewandelt = изменяться  
wegbleiben — bleibt weg — ist weggeblieben — blieb weg = отсутствовать  
weichen — ist gewichen — wich = уступать / отходить  
weigern — geweigert = отказываться  
wochenlang = продолжающийся неделями  
zensieren — zensiert = цензурировать  
zumal = тем более  
zurückweisen — weist zurück — zurückgewiesen — wies zurück = отклонять  
ökologisch = экологический  
überlastet = перегруженный  
übersteigen — überstiegen — überstieg = превышать  
der Hebel — Hebel = рычаг  
das Heilmittel — Heilmittel = лекарство  
die Hemmschwelle — Hemmschwellen = психологический барьер  
die Hingabe — Hingaben = преданность  
die Historie — Historien = история  
häufig = частый  
illegal = нелегальный  
indisch = индийский  
interessant = интересный  
international = международный  
kämpfen — gekämpft = бороться  
klimafreundlich = экологичный (по отношению к климату)  
klinisch = клинический  
kontrovers = спорный  
kreativ = креативный  
kulturell = культурный  
legalisieren — legalisiert = узаконивать  
leicht = лёгкий  
modern = современный  
nötig = необходимый  
offiziell = официальный  
oft = часто  
politisch = политический  
prominent = известный  
radikal = радикальный  
revolutionär = революционный  
riskant = рискованный  
saisonal = сезонный  
sanft = мягкий  
schwierig = трудный  
sicher = безопасный  
solidarisch = солидарный  
stabil = стабильный  
touristisch = туристический  
typisch = типичный  
die Spannung — Spannungen = напряжение  
der Spielraum — Spielräume = свобода действий  
der Staatsbürger — Staatsbürger = гражданин  
die Stadtplanung — Stadtplanungen = градостроительство  
das Stigma — Stigmen = клеймо  
die Stärkung — Stärkungen = укрепление  
die Subvention — Subventionen = субсидия  
der Suizid — Suizide = самоубийство  
das Surfen = сёрфинг  
das Tabu — Tabus = табу  
die Teilhabe — Teilhaben = участие  
das Tempo — Tempi = темп  
das Territorium — Territorien = территория  
das Theaterstück — Theaterstücke = театральная пьеса  
die Tradition — Traditionen = традиция  
die Transaktion — Transaktionen = транзакция  
der Transport — Transporte = транспортировка  
der Tumor — Tumore = опухоль  
das Ufer — Ufer = берег  
das Umland — Umländer = пригород  
die Umsetzung — Umsetzungen = реализация  
der Umweg — Umwege = обходной путь  
der Unmut = недовольство  
die Unterbrechung — Unterbrechungen = прерывание  
die Unterdrückung — Unterdrückungen = угнетение  
die Unterhaltung — Unterhaltungen = развлечение  
der Unterstützer — Unterstützer = сторонник  
die Validierung — Validierungen = валидация  
die Variante — Varianten = вариант  
die Verarbeitung — Verarbeitungen = обработка  
verbergen — verbirgt — verborgen — verbarg = скрывать  
das Verbrechen — Verbrechen = преступление  
die Verbrennung — Verbrennungen = сжигание  
der Verfall — Verfälle = упадок  
die Verfügbarkeit = доступность  
das Vergnügen — Vergnügen = удовольствие  
das Verhör — Verhöre = допрос  
die Verkündung — Verkündungen = провозглашение  
die Verleumdung — Verleumdungen = клевета  
die Verpflichtung — Verpflichtungen = обязательство  
die Verschärfung — Verschärfungen = ужесточение  
das Versprechen — Versprechen = обещание  
die Verteilung — Verteilungen = распределение  
die Verurteilung — Verurteilungen = осуждение  
die Vielfalt = разнообразие  
das Volumen — Volumen = объём  
die Vorspeise — Vorspeisen = закуска  
die Waffe — Waffen = оружие  
das Wahlergebnis — Wahlergebnisse = результат выборов  
die Wahrheit — Wahrheiten = правда  
der Widerstand — Widerstände = сопротивление  
der Wiederaufbau = восстановление  
das Wissen = знания  
die Wissenschaft — Wissenschaften = наука  
das Wohlbefinden = благополучие  
der Wohnungsbau = жилищное строительство  
die Wut = ярость  
zentral = центральный  
zerstören — zerstört = разрушать  
zivil = гражданский  
die Zunahme — Zunahmen = увеличение  
der Zusammenbruch — Zusammenbrüche = крах  
die Zuständigkeit — Zuständigkeiten = компетенция  
abgrenzen — grenzt ab — abgegrenzt = разграничивать  
abhängen — hängt ab — abgehangen — hing ab = зависеть  
abrechnen — rechnet ab — abgerechnet = рассчитываться  
abschließend = заключительный  
absehbar = предсказуемый  
absteigen — steigt ab — ist abgestiegen — stieg ab = спускаться  
aktualisieren — aktualisiert = обновлять  
alkoholfrei = безалкогольный  
analysieren — analysiert = анализировать  
anbauen — baut an — angebaut = выращивать  
aneinanderreihen — reiht aneinander — aneinandergereiht = соединять в ряд  
anfällig = предрасположенный  
angebracht = уместный  
angehören — gehört an — angehört = принадлежать  
anklagen — klagt an — angeklagt = обвинять  
ankurbeln — kurbelt an — angekurbelt = стимулировать  
anlaufen — läuft an — ist angelaufen — lief an = запускаться  
annähern — nähert an — angenähert = приближаться  
anordnen — ordnet an — angeordnet = предписывать  
anpreisen — preist an — angepriesen — pries an = расхваливать  
ansetzen — setzt an — angesetzt = назначать  
ansiedeln — siedelt an — angesiedelt = заселять  
anspruchsvoll = требовательный  
antreiben — treibt an — angetrieben — trieb an = приводить в движение  
antreten — tritt an — angetreten — trat an = приступать  
anziehen — zieht an — angezogen — zog an = привлекать  
architektonisch = архитектурный  
archäologisch = археологический  
atemberaubend = захватывающий  
auffordern — fordert auf — aufgefordert = призывать  
aufführen — führt auf — aufgeführt = исполнять  
aufheizen — heizt auf — aufgeheizt = нагревать  
aufleben — lebt auf — ist aufgelebt = оживать  
aufrechterhalten — erhält aufrecht — aufrechterhalten — erhielt aufrecht = поддерживать  
aufspüren — spürt auf — aufgespürt = выискивать  
aufstrebend = устремлённый вверх  
aufwerten — wertet auf — aufgewertet = повышать ценность  
ausbreiten — breitet aus — ausgebreitet = распространять  
ausbremsen — bremst aus — ausgebremst = сдерживать  
ausbauen — baut aus — ausgebaut = расширять  
ausbeuten — beutet aus — ausgebeutet = эксплуатировать  
ausbilden — bildet aus — ausgebildet = обучать  
ausdehnen — dehnt aus — ausgedehnt = расширять  
ausgehen — geht aus — ist ausgegangen — ging aus = выходить  
ausgleichen — gleicht aus — ausgeglichen — glich aus = уравновешивать  
ausrichten — richtet aus — ausgerichtet = организовывать  
ausruhen — ruht aus — ausgeruht = отдыхать  
ausrüsten — rüstet aus — ausgerüstet = оснащать  
aussagekräftig = содержательный  
aussagen — sagt aus — ausgesagt = давать показания  
ausschließen — schließt aus — ausgeschlossen — schloss aus = исключать  
automatisiert = автоматизированный  
basieren — basiert = основываться  
baufällig = ветхий  
beabsichtigen — beabsichtigt = намереваться  
beauftragen — beauftragt = поручать  
bedeckt = покрытый  
beeinflussen — beeinflusst = оказывать влияние  
beenden — beendet = заканчивать  
befähigen — befähigt = делать способным  
befördern — befördert = перевозить  
befürchten — befürchtet = опасаться  
befürworten — befürwortet = одобрять  
begehren — begehrt = жаждать  
begrüßen — begrüßt = приветствовать  
beheben — behoben — behob = устранять  
beherbergen — beherbergt = приютить  
behindern — behindert = препятствовать  
behutsam = осторожный  
bekleiden — bekleidet = занимать должность  
belastbar = выносливый  
belastend = обременяющий  
benachteiligen — benachteiligt = ущемлять  
benehmen — benimmt — benommen — benahm = вести себя  
berechtigen — berechtigt = давать право  
berühmt = знаменитый  
beschaffen — beschafft = добывать  
bescheren — beschert = дарить  
beschleunigen — beschleunigt = ускорять  
beschränken — beschränkt = ограничивать  
beschuldigen — beschuldigt = обвинять  
beseitigen — beseitigt = устранять  
besprühen — besprüht = распылять  
bestatten — bestattet = хоронить  
bestechen — besticht — bestochen — bestach = подкупать  
bestrafen — bestraft = наказывать  
bestreben — bestrebt = стремиться  
beständig = постоянный  
betreuen — betreut = опекать  
bewaffnen — bewaffnet = вооружать  
bewahren — bewahrt = сохранять  
bewohnen — bewohnt = населять  
bewundern — bewundert = восхищаться  
bewältigen — bewältigt = преодолевать  
blicken — geblickt = смотреть  
blitzschnell = молниеносный  
brachial = грубый  
brauchbar = пригодный  
brutal = жестокий  
definieren — definiert = определять  
demonstrieren — demonstriert = демонстрировать  
denkmalgeschützt = охраняемый как памятник культуры  
deportieren — deportiert = депортировать  
depressiv = депрессивный  
detailreich = детализированный  
diplomatisch = дипломатический  
diskutieren — diskutiert = обсуждать  
distanzieren — distanziert = дистанцироваться  
drastisch = радикальный  
dreidimensional = трёхмерный  
dulden — geduldet = терпеть  
durchdacht = продуманный  
durchgreifen — greift durch — durchgegriffen — griff durch = принимать решительные меры  
durchqueren — durchquert = пересекать  
dynamisch = динамичный  
effektiv = эффективный  
einbeziehen — bezieht ein — einbezogen — bezog ein = вовлекать  
einbinden — bindet ein — eingebunden — band ein = интегрировать  
eingängig = легко запоминающийся  
einhellig = единодушный  
einig = единый  
einsam = одинокий  
einschlägig = соответствующий  
einstimmig = единогласный  
ekelhaft = отвратительный  
endgültig = окончательный  
energieeffizient = энергоэффективный  
entfliehen — ist entflohen — entfloh = сбегать  
entführen — entführt = похищать  
entgehen — entgeht — ist entgangen — entging = избегать  
entlegen = отдалённый  
entsetzt = потрясённый  
entspannt = расслабленный  
entziehen — entzogen — entzog = лишать  
erarbeiten — erarbeitet = разрабатывать  
erbauen — erbaut = сооружать  
erfreuen — erfreut = радовать  
ergreifen — ergriffen — ergriff = схватывать  
erhöhen — erhöht = повышать  
ernsthaft = серьёзный  
erproben — erprobt = испытывать  
errichten — errichtet = возводить  
erschließen — erschlossen — erschloss = осваивать  
erschreckend = пугающий  
erschweren — erschwert = усложнять  
erschüttern — erschüttert = потрясать  
ertragen — erträgt — ertragen — ertrug = терпеть  
erwecken — erweckt = пробуждать  
erweitern — erweitert = расширять  
erwerben — erwirbt — erworben — erwarb = приобретать  
etablieren — etabliert = учреждать  
ethisch = этический  
ethnisch = этнический  
experimentell = экспериментальный  
faktisch = фактический  
faszinieren — fasziniert = восхищать  
fehlerhaft = ошибочный  
fern = далёкий  
festlegen — legt fest — festgelegt = устанавливать  
fettig = жирный  
fiktiv = вымышленный  
flanieren — ist flaniert = прогуливаться  
flott = бодрый  
fraglich = сомнительный  
fragwürdig = сомнительный  
frappierend = поразительный  
freiheitlich = свободный  
freizügig = свободный в поведении  
frequentieren — frequentiert = часто посещать  
fruchtbar = плодородный  
fröhlich = весёлый  
fungieren — fungiert = исполнять обязанности  
fürstlich = княжеский  
gebacken = запечённый  
gebracht = принесённый  
gebucht = забронированный  
geduldet = терпимый  
gefordert = востребованный  
gefunden = найденный  
gegründet = основанный  
gehandelt = торгуемый  
gehoben = возвышенный  
gelitten = страдающий  
geltend = действующий  
gemäßigt = умеренный  
genehmigen — genehmigt = одобрять  
geopolitisch = геополитический  
geprägt = характеризующийся  
gerichtlich = судебный  
geräuschvoll = шумный  
gesamtheitlich = целостный  
geschätzt = уважаемый  
geschützt = защищённый  
gespritzt = впрыскиваемый  
gestaltet = оформленный  
gestraft = наказанный  
gewaltsam = насильственный  
glänzend = блестящий  
gravierend = серьёзный  
gutgehen — geht gut — ist gutgegangen — ging gut = идти хорошо  
harmonieren — harmoniert = гармонировать  
heftig = сильный  
herausgeben — gibt heraus — herausgegeben — gab heraus = издавать  
herausstellen — stellt heraus — herausgestellt = выявлять  
hergestellt = изготовленный  
herunterkommen — kommt herunter — ist heruntergekommen — kam herunter = приходить в упадок  
herzhaft = сердечный  
hilflos = беспомощный  
himmlisch = божественный  
hinausgehen — geht hinaus — ist hinausgegangen — ging hinaus = выходить за пределы  
hindern — gehindert = мешать  
hochentwickelt = высокоразвитый  
hochmodern = ультрасовременный  
hochrangig = высокопоставленный  
höchst = высочайший  
ideologisch = идеологический  
ikonisch = культовый  
imaginär = воображаемый  
imitieren — imitiert = подражать  
ineffizient = неэффективный  
informativ = информативный  
inhaftieren — inhaftiert = арестовывать  
inhalieren — inhaliert = вдыхать  
inhaltlich = содержательный  
innovativ = инновационный  
instabil = нестабильный  
integriert = интегрированный  
intensiv = интенсивный  
interaktiv = интерактивный  
investigativ = расследовательский  
irreführend = вводящий в заблуждение  
irritierend = раздражающий  
kandidieren — kandidiert = баллотироваться  
kassieren — kassiert = получать деньги  
klimaneutral = климатически нейтральный  
klären — geklärt = выяснять  
kommentieren — kommentiert = комментировать  
komödiantisch = комедийный  
konsumieren — konsumiert = потреблять  
kontinuierlich = непрерывный  
konzipieren — konzipiert = разрабатывать  
koppeln — gekoppelt = связывать  
kosmetisch = косметический  
kreativ = креативный  
kreuzen — gekreuzt = пересекать  
kultivieren — kultiviert = культивировать  
kunstvoll = искусный  
kurios = курьёзный  
kühl = прохладный  
kündigen — gekündigt = расторгать  
langjährig = многолетний  
lebensecht = реалистичный  
lebenswert = достойный жизни  
legitim = законный  
leidenschaftlich = страстный  
leise = тихий  
leistungsstark = высокопроизводительный  
leitend = руководящий  
letzter = последний  
liegend = лежащий  
lächerlich = смехотворный  
majestätisch = величественный  
malerisch = живописный  
manipulieren — manipuliert = манипулировать  
maritim = морской  
markant = выразительный  
massenhaft = массовый  
maßgeblich = значительный  
mehrstündig = многочасовой  
mental = умственный  
minimalistisch = минималистичный  
mitunter = иногда  
moderat = умеренный  
modisch = модный  
monatelang = месяцы напролёт  
mondän = шикарный  
multifunktional = многофункциональный  
multikulturell = мультикультурный  
muslimisch = мусульманский  
mutieren — ist mutiert = мутировать  
mystisch = мистический  
mächtig = могущественный  
märchenhaft = сказочный  
mündlich = устный  
nachhaltig = устойчивый  
nachweisbar = доказуемый  
national = национальный  
naturnah = близкий к природе  
nerven — genervt = раздражать  
nostalgisch = ностальгический  
notfalls = в крайнем случае  
notorisch = пресловутый  
nächtlich = ночной  
nähern — genähert = приближаться  
oftmalig = многократный  
original = оригинальный  
orthodox = ортодоксальный  
pandemiebedingt = вызванный пандемией  
passioniert = страстный  
physisch = физический  
pittoresk = живописный  
plausibel = правдоподобный  
potenziell = потенциальный  
preisgünstig = недорогой  
primär = первичный  
prinzipiell = принципиальный  
produktiv = продуктивный  
profitabel = прибыльный  
provokativ = провокационный  
prächtig = великолепный  
prägend = определяющий  
pulsieren — es pulsiert — hat pulsiert — pulsierte = пульсировать  
qualitativ = качественный  
radikal = радикальный  
reaktionär = реакционный  
rechtfertigen — gerechtfertigt = оправдывать  
rechtlich = юридический  
rechtsstaatlich = правовой (в контексте правового государства)  
regieren — regiert = управлять  
reißen — gerissen — riss = рвать  
reproduzieren — reproduziert = воспроизводить  
residieren — residiert = проживать (официально)  
ressourcensparend = ресурсосберегающий  
rotieren — rotiert = вращаться  
rätselhaft = загадочный  
rücksichtsvoll = внимательный (к другим)  
sahnig = сливочный  
saisonabhängig = зависящий от сезона  
saniert = отреставрированный  
saufen — säuft — gesoffen — soff = бухать  
schaden — geschadet = вредить  
schauerlich = жуткий  
scheinbar = кажущийся  
scheuen — gescheut = избегать  
schillernd = переливающийся  
schlauchen — geschlaucht = изнурять  
schleifen — geschliffen — schliff = шлифовать  
schlendern — ist geschlendert = бродить  
schlicht = простой  
schneebedeckt = покрытый снегом  
schocken — geschockt = шокировать  
schockieren — schockiert = потрясать  
schräg = наклонный  
schweigen — geschwiegen — schwieg = молчать  
schweißen — geschweißt = сваривать  
schwermachen — macht schwer — hat schwer gemacht = усложнять  
schöpfen — geschöpft = черпать  
sehenswert = достойный просмотра  
selbstbezogen = эгоцентричный  
sexy = сексуальный  
skandinavisch = скандинавский  
speisen — gespeist = кушать  
spekulieren — spekuliert = спекулировать  
spezifisch = специфический  
spiegeln — gespiegelt = отражать  
spontan = спонтанный  
spürbar = ощутимый  
stagnieren — stagniert = стагнировать  
steigern — gesteigert = увеличивать  
stetig = постоянный  
stets = всегда  
strecken — gestreckt = вытягивать  
stressvoll = стрессовый  
strotzen — gestrotzt = изобиловать  
stürmen — ist gestürmt = штурмовать  
surreal = сюрреалистичный  
symbolisieren — symbolisiert = символизировать  
szenisch = сценический  
tauchen — ist getaucht = нырять  
toxikologisch = токсикологический  
transparent = прозрачный  
trendig = модный  
trist = унылый  
umfassend = обширный  
umgangssprachlich = разговорный  
umgestalten — gestaltet um — umgestaltet = переделывать  
umkommen — kommt um — ist umgekommen — kam um = погибать  
umsiedeln — siedelt um — ist umgesiedelt = переселяться  
unauffällig = незаметный  
unaufhaltsam = неудержимый  
unbegründet = необоснованный  
unerträglich = невыносимый  
unfehlbar = безошибочный  
ungewohnt = непривычный  
unheimlich = жуткий  
unkontrolliert = неконтролируемый  
unmoralisch = аморальный  
unpassend = неуместный  
unterbinden — unterbunden — unterband = пресекать  
unterbrechen — unterbricht — unterbrochen — unterbrach = прерывать  
unterhaltsam = занимательный  
unterliegen — unterlegen — unterlag = подлежать  
untersagen — untersagt = запрещать  
untersuchen — untersucht = исследовать  
unumstritten = бесспорный  
urban = городской  
urgemütlich = очень уютный  
verabreichen — verabreicht = выдавать (лекарства, еду)  
verachten — verachtet = презирать  
verbergen — verbirgt — verborgen — verbarg = скрывать  
verblüffen — verblüfft = поражать  
verdoppeln — verdoppelt = удваивать  
verdächtigen — verdächtigt = подозревать  
vereinigen — vereinigt = объединять  
vergeblich = напрасный  
vergrößern — vergrößert = увеличивать  
verhängen — verhängt = вводить (санкции, запреты)  
verirren sich — verirrt = заблудиться  
verkehren — verkehrt = общаться, курсировать  
verknüpfen — verknüpft = связывать  
verleihen — verliehen — verlieh = придавать, одалживать  
vermehren — vermehrt = увеличивать, размножать  
vernachlässigen — vernachlässigt = пренебрегать  
verringern — verringert = уменьшать  
verschaffen — verschafft = добывать  
verschlechtern — verschlechtert = ухудшать  
verschlimmern — verschlimmert = усугублять  
verschlossen = замкнутый, закрытый  
verschonen — verschont = щадить  
versprühen — versprüht = распылять  
verstecken — versteckt = прятать  
verströmen — verströmt = источать (запах, атмосферу)  
verteidigen — verteidigt = защищать  
verteufeln — verteufelt = демонизировать  
verteuern — verteuert = удорожать  
vertrauenswürdig = заслуживающий доверия  
verursachen — verursacht = вызывать (последствия)  
vervielfachen — vervielfacht = многократно увеличивать  
verweigern — verweigert = отказывать  
verwinkelt = извилистый, запутанный  
verwunderlich = удивительный  
vielversprechend = многообещающий  
volatil = нестабильный (экономика, рынок)  
vorangehen — geht voran — ist vorangegangen — ging voran = идти впереди  
vorankommen — kommt voran — ist vorangekommen — kam voran = продвигаться  
wach = бодрый  
wachsam = бдительный  
wagemutig = отважный  
wappnen — gewappnet = подготовиться (к трудностям)  
weben — gewebt = ткать  
wecken — geweckt = будить  
weiß = белый  
weiterentwickeln — entwickelt weiter — weiterentwickelt = развивать дальше  
weltberühmt = всемирно известный  
widerlich = отвратительный  
wiederherstellen — stellt wieder her — wiederhergestellt — stellte wieder her = восстанавливать  
wirksam = эффективный  
wissenschaftlich = научный  
wohlhabend = состоятельный  
wundern sich — gewundert = удивляться  
zahlungskräftig = платежеспособный  
zerbrechen — zerbricht — zerbrochen — zerbrach = разбиваться  
zielen — gezielt = целиться  
zugutekommen — kommt zugute — ist zugutegekommen — kam zugute = приносить пользу  
zukommen — kommt zu — ist zugekommen — kam zu = предстоять (кому-то)  
zulegen — legt zu — zugelegt = прибавлять (вес, деньги)  
zurückbringen — bringt zurück — zurückgebracht — brachte zurück = возвращать  
zurückdrängen — drängt zurück — zurückgedrängt = оттеснять  
zurückgehen — geht zurück — ist zurückgegangen — ging zurück = уменьшаться, возвращаться  
zurücklegen — legt zurück — zurückgelegt = откладывать (деньги, расстояние)  
zurückziehen — zieht zurück — zurückgezogen — zog zurück = отзывать, отступать  
zusichern — sichert zu — zugesichert = гарантировать  
zutiefst = глубоко (эмоционально)  
zunehmen — nimmt zu — zugenommen — nahm zu = увеличиваться, прибавлять (вес)  
zwangsläufig = неизбежный  
zweifelhaft = сомнительный  
zweifellos = несомненный  
äußerlich = внешний  
äußern — geäußert = высказывать  
örtlich = местный  
überfordert = перегруженный (информацией, работой)  
überwachen — überwacht = контролировать  
überwiegen — überwogen — überwog = преобладать  
überzeugend = убедительный  