sein — ist gewesen = быть =
und = и =
wir = мы =
ich = я =
in = в =
hier = здесь =
haben — er hat — gehabt = иметь =
es = оно, это =
so = так =
ja = да =
auch = также =
nicht = не =
zu = к, на =
aber = но =
für = для, за =
mal = раз =
mit = с =
man = человек, кто-то =
gut = хороший =
da = там, потому что =
du = ты =
schon = уже =
was = что =
jetzt = сейчас =
sich befinden — sich befunden = находиться
auf = на =
noch = ещё =
die Musik = музыка =
an = на, у =
von = от =
werden — er wird — ist geworden = становиться =
können — ich/er kann — konnte — könnte = мочь/уметь физически =
ganz = целый
sie = она, они =
schön = красивый =
oder = или =
die Stadt = город =
machen — gemacht = делать =
wie = как =
dieser = этот =
der Euro = евро =
aus = из =
dass = что =
wenn = если, когда =
dann = тогда, затем =
sehr = очень =
geben — er gibt — gegeben = давать =
bei = у, при =
sehen — er sieht — gesehen = видеть =
unser = наш =
richtig = правильный =
uns = нас, нам =
wer = кто =
kommen — ist gekommen = приходить =
sagen — gesagt = говорить =
groß = большой =
also = итак, значит =
doch = всё же, однако =
alle = все =
nur = только =
wieder = снова
wirklich = действительно
Hallo = привет =
genau = точный
ihr = вы, ваш =
dir = тебе =
klein = маленький =
als = как, когда =
gehen — ist gegangen = идти =
gerne = с удовольствием
mir = мне =
einfach = простой =
jeder = каждый =
nach = после, в (направление) =
finden — gefunden = находить =
kein = никакой =
die Welt = мир =
bissch = немного (сокращение от „ein bisschen”)
echt = настоящий
gleich = такой же, сразу =
mehr = больше =
mein = мой =
viel = много =
denn = потому что, так как; именно
fast = почти =
immer = всегда =
nehmen — er nimmt — genommen = брать
lang = длинный =
lecker = вкусный
natürlich = естественно =
das Jahr = год =
die Kirche = церковь
der Tag = день =
ach = ах =
alt = старый =
gar = совсем =
toll = классный
wo = где =
um = вокруг, около =
wollen — ich/er will — wollte = хочу =
die Kunst = искусство =
heute = сегодня =
müssen — ich/er muss — musste — müsste = нужно =
vor = перед =
die Leute = люди =
Paris = Париж =
dich = тебя =
durch = через =
fahren — er fährt — ist gefahren = ехать
mich = меня =
ne = не (разговорное) =
sollen — ich/er soll — sollte — sollte = обязан =
der Fall = случай =
dazu = к этому, для этого
kosten — gekostet = стоить
nein = нет =
nichts = ничего =
rein = чистый
weil = потому что =
das Schnitzel = шницель =
Wien = Вена =
denken an {Akk.} — gedacht = думать о
direkt = прямой
glauben an {Akk.} — geglaubt = верить в
günstig = выгодный, удобный
los = старт, исчезнуть =
vielleicht = возможно =
über = над, о =
der Markt = рынок =
damit = для того чтобы; с этим =
erst = сначала, только
gerade = прямо, только что
hoch = высокий =
lassen — er lässt — gelassen = позволять
liegen — gelegen = лежать
seit = начиная с =
voll = полный =
die Ecke = угол
der Mensch = человек =
die Reise = путешествие
das Wasser = вода =
das Zimmer = комната =
aller = весь, все =
eigentlich = на самом деле
essen — er isst — gegessen = есть
genießen — genossen = наслаждаться
heißen — geheißen = называться
je = когда-либо
schaffen — geschafft = справляться, создавать
sondern = а, но =
stehen — gestanden = стоять
stimmen — gestimmt = быть верным, голосовать
teuer = дорогой =
weiter = дальше =
zeigen — gezeigt = показывать
das Bier = пиво =
Deutschland = Германия =
die Frau = женщина, жена =
das Hotel = отель =
das Viertel = квартал, четверть =
der Wein = вино =
der Wiener = вьеннец =
bis = до =
dürfen — ich/er darf — durfte — dürfte = разрешать / возможность — сесть, помочь, курить, идти =
gucken — geguckt = смотреть
normal = нормальный
oben = наверху =
probieren — probiert = пробовать =
raus = наружу
sonst = иначе
suchen — gesucht = искать =
süß = сладкий
total = полный
traditionell = традиционный
wissen — gewusst = знать
zurück = назад =
die Geschichte = история
das Herz = сердце
das Muss = необходимость
das Münster = монастырь
der Turm = башня
die Tür = дверь =
das Wetter = погода =
die Zeit = время =
am = на (сокращение от „an dem”) =
dank = благодаря
dein = твой =
deswegen = поэтому
drauf = на это (разговорное)
eben = как раз, именно
einmal = один раз =
er = он =
etwas = что-то =
euch = вас =
klingen — geklungen = звучать
schauen — geschaut = смотреть
schlecht = плохой =
teilen — geteilt = делиться
tun — getan = делать
unter = под =
wahrscheinlich = вероятно
willkommen = приветствуемый =
der Anfang = начало
die Art = вид
die Ausstellung = выставка
der Berg = гора =
das Brot = хлеб =
der Dank = благодарность
das Fenster = окно =
der Garten = сад =
das Haus = дом =
die Idee = идея =
der Kaffee = кофе
das Konzept = концепция
die Küche = кухня
das Licht = свет
die Lust = желание =
das Mal = раз =
der Morgen = утро =
die Seite = сторона
der Teil = часть =
der Tourist = турист
anders = другой =
arbeiten — gearbeitet = работать =
bieten — geboten = предлагать
dabei = при этом, с этим =
davon = от этого =
draußen = снаружи
erzählen — erzählt = рассказывать =
fliegen — ist geflogen = лететь
gehören zu {Dat.} — gehört = принадлежать к
geil = классный, крутой
gemütlich = уютный
gestern = вчера =
hinter = за
landen — gelandet = приземляться
neu = новый =
ob = ли =
ohne = без =
pro = за (единицу) =
schmecken — geschmeckt = вкусить, быть вкусным
schnell = быстрый =
spät = поздний =
typisch = типичный
unten = внизу =
unterwegs = в пути
vorne = спереди
wahnsinnig = сумасшедший
warum = почему =
weit = далеко
wunderschön = великолепный =
zusammen = вместе =
übrigens = кстати
das Auge = глаз =
die Aussicht = вид, перспектива
der Blick = взгляд
das Ding = вещь
das Geld = деньги =
das Gesicht = лицо
Gott = Бог
die Menge = количество
der Platz = место =
das Restaurant = ресторан =
die Schweiz = Швейцария
der Spaß = удовольствие =
das Thema = тема =
der Urlaub = отпуск =
das Wunder = чудо
beeindruckend = впечатляющий
beliebt = популярный
berühmt = знаменитый
bitte = пожалуйста =
cool = крутой =
dafür = за это, для этого =
eher = скорее
entdecken — entdeckt = обнаруживать
fehlen — gefehlt = отсутствовать
früh = ранний =
fällen — gefällt = рубить, сбрасывать
gern = охотно =
her = сюда, отсюда =
hören — gehört = слышать
irgendwas = что-то =
jung = молодой
kaum = едва
klassisch = классический
knapp = почти
kreativ = креативный
kriegen — gekriegt = получать
leben — gelebt = жить =
links = слева =
nie = никогда =
oh = ох =
perfekt = идеальный
rund = круглый =
sogar = даже
sozial = социальный
spannend = захватывающий
sprechen — er spricht — gesprochen = говорить =
tragen — er trägt — getragen = носить
versuchen — versucht = пытаться
warten auf {Akk.} — gewartet = ждать чего-либо =
wohl = хорошо, вероятно
während = во время
ziehen — gezogen = тянуть, переезжать
ziemlich = довольно
zählen — gezählt = считать
überlegen — überlegt = обдумывать
die Arbeit = работа =
der Boden = земля, пол
Deutsch = немецкий =
der Einwohner = житель
das Ende = конец
Europa = Европа =
die Familie = семья =
der Flug = рейс, полет
die Frage = вопрос =
Frankreich = Франция =
der Geschmack = вкус
das Geschäft = бизнес, магазин =
das Gewürz = специя
das Glas = стекло =
das Glück = счастье =
die Grenze = граница
das Gut = добро, имущество
das Kind = ребёнок =
das Kino = кино =
der Künstler = художник
das Land = страна =
das Leben = жизнь =
die Luft = воздух =
die Metropole = метрополия =
der Name = имя =
die Nähe = близость
das Produkt = продукт
die Sache = вещь, дело =
das Schwein = свинья =
der Sinn = смысл
die Spezialität = специальность
der Strand = пляж
die Straße = улица =
die Suche = поиск
die Tradition = традиция
das Werk = произведение, работа
ab = от, с =
anfangen — angefangen = начинать =
beginnen — begonnen = начинать
beide = оба =
bekannt = известный
bekommen — bekommen = получать
besonders = особенно
bestimmen — bestimmt = определять
brauchen — gebraucht = нуждаться
deutsch = немецкий =
ehrlich = честный
erleben — erlebt = переживать
fallen — er fällt — ist gefallen = падать
französisch = французский =
fühlen {sich} — gefühlt = чувствовать что-то {чувствовать себя} =
gegessen — essen — gegessen = есть =
hin = туда
hinten = сзади =
hoffen auf {Akk.} — gehofft = надеяться на
ihnen = им
irgendwo = где-то =
kennen — gekannt = знать
komplett = полный
laufen — er läuft — ist gelaufen = бегать, идти
lohnen — gelohnt = стоить
merken — gemerkt = замечать
mischen — gemischt = смешивать
mitnehmen — mitgenommen = брать с собой
modern = современный =
nah = близкий
nennen — genannt = называть
sicher = безопасный
sofort = немедленно
trotzdem = всё равно
unbedingt = обязательно
unglaublich = невероятный
verschieden = различный
weniger = меньше =
überall = везде
überhaupt = вообще
überraschen — überrascht = удивлять =
der Abend = вечер =
die Altstadt = старый город
die App = приложение =
die Architektur = архитектура
der Berliner = берлинец =
der Besucher = посетитель
der Chef = начальник =
die Etage = этаж
die Fahrt = поездка
das Fleisch = мясо =
die Form = форма
der Freund = друг =
das Frühstück = завтрак =
der Fuß = нога =
die Galerie = галерея =
das Gemüse = овощи
die Hand = рука =
die Handarbeit = ручная работа
die Hauptstadt = столица
die Herzen = сердца =
die Innenstadt = центр города
das Jahrhundert = век
der Klassiker = классика =
die Kosten = затраты
der Laden = магазин =
das Meer = море =
die Minute = минута =
die Mode = мода
das Museum = музей =
der Musiker = музыкант
die Mutter = мать =
die Natur = природа
das Netz = сеть
der Ort = место =
die Person = человек
die Perspektive = перспектива
der Preis = цена =
das Problem = проблема =
die Region = регион
der Rest = остаток
die Richtung = направление
das Schiff = корабль
die Schokolade = шоколад =
der Schritt = шаг =
der Schwarzwald = Шварцвальд =
die Sicht = вид
die Stimmung = настроение =
der Student = студент =
das Stück = кусок, часть =
die Szene = сцена
das Tier = животное =
der Tisch = стол =
die Wahl = выбор
die Woche = неделя =
absolut = абсолютный
alleine = один =
ausschließlich = исключительно
außergewöhnlich = исключительный
backen — gebacken = печь
bauen — gebaut = строить
bestellen — bestellt = заказывать
bewegen {sich} — bewegt = двигать что-то; {двигаться}
bisher = до сих пор
bleiben — ist geblieben = оставаться
bringen — gebracht = приносить
buchen — gebucht = бронировать
damals = тогда
darum = поэтому =
davor = до этого =
definitiv = определённо
deshalb = поэтому =
dran = на это (разговорное) =
drin = внутри
drinnen = внутри
eigen = собственный
einstellen — eingestellt = настраивать, прекращать
einzig = единственный
endlich = наконец
entstehen — ist entstanden = возникать
erinnern {sich} an {Akk.} — erinnert = напоминать о; {помнить о}
erkennen — erkannt = узнавать
erwarten — erwartet = ожидать
extra = дополнительный
falsch = неправильный =
fein = изысканный
fragen — gefragt = спрашивать =
freuen {sich} über / auf {Akk.} — gefreut = радовать; {радоваться / предстоящему}
frisch = свежий =
froh = радостный
früher = раньше =
führen — geführt = вести
gelten — gegolten = считаться
gestalten — gestaltet = оформлять
gleichzeitig = одновременно
grün = зелёный =
hierher = сюда
historisch = исторический
hochwertig = высококачественный
innen = внутри
irgendein = какой-то
irgendwelcher = какой-то =
irgendwie = каким-то образом =
jedenfalls = в любом случае
jemand = кто-то
kalt = холодный =
kaufen — gekauft = покупать =
kennenlernen — kennengelernt = знакомиться =
klar = ясный =
kochen — gekocht = готовить
kurz = короткий =
legen — gelegt = класть
leicht = лёгкий
lieben — geliebt = любить =
manchmal = иногда =
meinen — gemeint = думать, считать
mitten = в середине
mutig = смелый
möchten — ich/er möchte = хотел бы (would like) =
möglich = возможный =
na = ну =
nee = нет =
nix = ничего
nun = теперь =
recht = правый, правильный
reden — geredet = говорить =
reich = богатый
reisen — gereist = путешествовать
selbst = сам
setzen {sich} — gesetzt = садиться; {ставить, помещать}
sieben = семь =
sitzen — ist gesessen = сидеть
sozusagen = так сказать =
sparen — gespart = экономить
spielen — gespielt = играть =
starten — gestartet = стартовать =
stellen — gestellt = ставить, задавать (вопрос)
treffen {sich} — er trifft — getroffen = встречать, {встречаться} =
trinken — getrunken = пить
umso = тем более
unterschiedlich = различный
verkaufen — verkauft = продавать =
vorher = до этого
weg = путь, исчезнувший
wegen = из-за =
weltweit = всемирный
wichtig = важный =
wirken — gewirkt = действовать
wünschen — gewünscht = желать
zwar = хотя
zwischen = между =
die Ahnung = предчувствие
die Alternative = альтернатива
das Angebot = предложение =
die Angst = страх =
der Architekt = архитектор
der Artikel = статья, артикул
das Atelier = ателье =
der Auftrag = заказ
der Auftritt = выступление
der Ausblick = вид
die Autobahn = автомагистраль =
die Bahn = железная дорога
der Bahnhof = вокзал
die Baustelle = строительный объект
das Bauwerk = сооружение
der Betrieb = предприятие
das Bett = кровать =
die Beziehung = отношение
das Bild = картина, изображение =
die Brauerei = пивоварня
die Bühne = сцена
der Charakter = характер =
das Dach = крыша =
das Design = дизайн =
das Detail = деталь
das Dorf = деревня =
das Ei = яйцо =
der Eindruck = впечатление
die Eltern = родители =
die Erde = земля
die Erfahrung = опыт =
das Erlebnis = переживание
das Essen = еда =
der Experte = эксперт
die Farbe = цвет =
die Fassade = фасад
das Fest = праздник
die Figur = фигура
der Film = фильм =
der Fisch = рыба =
die Folge = следствие, серия
die Freude = радость
das Gas = газ
der Geburtstag = день рождения =
das Gebäude = здание
der Gedanke = мысль
die Generation = поколение
der Grad = градус =
die Großstadt = крупный город
der Grund = причина
die Gruppe = группа
die Größe = размер =
der Hafen = порт
die Heimat = родина =
die Heimatstadt = родной город
die Herausforderung = вызов
der Herr = господин =
das Highlight = кульминация
die Hilfe = помощь =
die Hälfte = половина
der Händler = торговец
die Inspiration = вдохновение
der Kaiser = император =
der Kanal = канал
der Krebs = рак
die Kultur = культура
das Kunstwerk = произведение искусства
der Käse = сыр =
der König = король =
der Körper = тело
die Lage = расположение
die Landschaft = пейзаж =
die Liebe = любовь
die Macht = власть
das Mehl = мука
die Million = миллион =
der Moment = момент =
der Motor = мотор =
das Mädchen = девочка =
die Möglichkeit = возможность
das Objekt = объект
der Park = парк =
der Plan = план =
der Planet = планета
das Programm = программа
das Publikum = публика =
der Raum = пространство
das Recht = право
der Respekt = уважение =
die Runde = круг
die Schulter = плечо =
die Schönheit = красота
der See = озеро =
der Sommer = лето =
das Spanien = Испания =
die Sprache = язык
der Stadtteil = район города
die Station = станция
der Stein = камень =
der Strom = электричество, поток
der Teller = тарелка
die Tonne = тонна
die Tour = тур
der Trend = тренд
der Tänzer = танцор
die Universität = университет =
der Ursprung = происхождение
die Verbindung = связь
der Versuch = попытка
das Video = видео =
das Vorbild = пример
der Wald = лес
der Weg = путь =
der Weltkrieg = мировая война
der Wert = значение, стоимость
das Wochenende = выходные =
das Wort = слово =
die Wurzel = корень
das Zentrum = центр
das Ziel = цель =
der Zuschauer = зритель
abends = по вечерам =
acht = восемь =
allein = один =
allerdings = однако
anbieten — angeboten = предлагать
angehen — angegangen = касаться, затрагивать
ansagen — angesagt = объявлять
anschauen — angeschaut = смотреть
anziehen — angezogen = надевать
arm = бедный
aufbauen — aufgebaut = строить, создавать
auskommen — ausgekommen = обходиться
aussehen — ausgesehen = выглядеть
außen = снаружи
außerhalb = за пределами
bald = скоро =
bedeuten — bedeutet = значить
bereiten — vorbereitet = готовить
beschäftigen — beschäftigt = заниматься
bestimmt = определённый
besuchen — besucht = посещать
bevor = до того как =
beweisen — bewiesen = доказывать
bislang = до сих пор
bunt = разноцветный =
dahin = туда
danach = после этого
dankbar = благодарный
darüber = об этом =
deutlich = ясный, четкий
dritter = третий =
dunkel = тёмный =
dünn = тонкий
ebenso = так же
egal = всё равно =
einige = несколько
einiger = некоторый
eins = один =
entfernt = удалённый
entscheiden — entschieden = решать
entspannen — entspannt = расслабляться
entweder = либо
entwerfen — entworfen = разрабатывать
erfahren — erfahren = узнавать, испытывать
erfinden — erfunden = изобретать
erfüllen — erfüllt = исполнять
erkunden — erkundet = исследовать
errichten — errichtet = сооружать
erschaffen — erschaffen = создавать
eröffnen — eröffnet = открывать
etwa = примерно
europäisch = европейский
exklusiv = эксклюзивный =
extrem = экстремальный
fertig = готовый =
finanziell = финансовый
frei = свободный
funktionieren — funktioniert = функционировать
fünf = пять =
genug = достаточно
geraten — geraten = попадать
glücklich = счастливый
großartig = великолепный
halb = половина =
halt = просто, ведь
halten — er hält — gehalten = держать
handeln — gehandelt = действовать
herrschen — geherrscht = господствовать
hey = привет =
hinterher = после этого, следом
hängen — gehangen = висеть
ihm = ему =
inspirieren — inspiriert = вдохновлять
integrieren — integriert = интегрировать =
interessant = интересный =
international = международный
kreieren — kreiert = создавать
lieb = милый
lieber = более милый, лучше (в сравнении)
malen — gemalt = рисовать
mancher = некоторый =
meist = в основном
meistens = чаще всего
miteinander = вместе
momentan = в данный момент
mögen — ich/er mag — mochte = нравится (like, ≠ would like) =
möglichst = насколько возможно
nachhaltig = устойчивый
neben = рядом
nebenan = рядом
niederländisch = нидерландский
normalerweise = обычно
nämlich = а именно
obwohl = хотя
oft = часто =
online = онлайн =
persönlich = личный
planen — geplant = планировать =
plötzlich = внезапно
rechnen — gerechnet = считать
regelmäßig = регулярный
relativ = относительно
rot = красный =
schlafen — er schläft — geschlafen = спать
schwer = тяжёлый =
schwierig = трудный =
selber = сам =
selten = редкий
solcher = такой
sorgen für {Akk.} — gesorgt = заботиться о
sowohl = как … так и
stammen — gestammt = происходить
stark = сильный
statt = вместо
steigen — ist gestiegen = подниматься
stolz = гордый
stoßen — gestoßen = толкать, наталкиваться
studieren — studiert = учиться
super = супер =
tatsächlich = фактически
teilweise = частично
trocken = сухой =
trotz = несмотря на
täglich = ежедневный
umgehen — umgegangen = обходиться
ungewöhnlich = необычный
unterscheiden — unterschieden = различать
unterstützen — unterstützt = поддерживать
verbinden — verbunden = соединять
verdanken — verdankt = быть обязанным
verdienen — verdient = зарабатывать
vergangen = прошедший
verlieren — verloren = терять
verrückt = сумасшедший
verstehen — verstanden = понимать =
vier = четыре =
viert = четвёртый =
vorbei = мимо
völlig = совершенно
wachsen — ist gewachsen = расти
wahr = истинный
wann = когда =
wechseln — gewechselt = менять
weiß = белый =
wenig = мало =
wohnen — gewohnt = жить =
wunderbar = чудесный
wär = был бы =
zahlen — gezahlt = платить
zerstören — zerstört = разрушать
zugleich = одновременно
zumindest = по крайней мере
zunächst = сначала
öffnen — geöffnet = открывать
übrig = оставшийся
sauer = кислый, испорченный, сердитый
das Kraut = трава, капуста, зелень
das Sauerkraut = квашенная капуста
der Zürcher = житель Цюриха
der Hunger = голод
riechen — ergerochen = пахнуть, нюхать
weißen — geweißt = белить
der Kreis = круг
der Mund = рот = 
der Schirm = зонт, экран
die Stufe = ступень, уровень
die Städtereise = путешествие по городам
der Städtetrip = поездка в город (короткое путешествие)
der Wahnsinn = безумие, сумасшествие
auffallen — er fällt auf — ist aufgefallen — fiel auf = бросаться в глаза, привлекать внимание
empfehlen — er empfiehlt — empfohlen — empfahl = рекомендовать
komisch = странно
nackt = голый
vegetarisch = вегетарианский
brüsten sich — gebrüstet = хвастаться
der Floh = блоха
der Flohmarkt = блошиный рынок
der Antikflohmarkt = блошиный рынок старины
der Antikmarkt = рынок старины
beißen — gebissen — biss = кусать
der Insider = посвящённый
geil (umgangssprachlich) = круто, похотливо (разговорно)
die Haube = колпак, капот
der Luxus = роскошь
die Schippe = лопатка, совок
schippen — geschippt = копать, сгребать (лопатой)
der Schinken = ветчина
der Snack = закуска
die Köstlichkeit = деликатес, лакомство
das Vergnügen = развлечение, удовольствие
das Städtchen = городок
besondere = особенный, необычный
bestaunen — bestaunt = восхищаться, любоваться
flüstern — geflüstert = шептать
entspannen — entspannt = расслабляться, отдыхать
spannen — gespannt = натягивать, напрягать
spannend = захватывающий
genüsslich = наслаждающийся, с удовольствием
freudig = радостный
genussfreudig = любящий наслаждения, гурман
hell = светло, светлый
herrlich = прекрасно
klopfen — geklopft = стучать, хлопать
mittendrin = посреди
schon mal = однажды
reingehen — er geht rein — ist reingegangen — ging rein = заходить внутрь
strahlen — gestrahlt = светиться, излучать свет
umsonst = бесплатно, напрасно
sonst = иначе
vielversprechend = многообещающий
die Überraschung = сюрприз =
die Adresse = адрес =
der Appetit = аппетит =
die Ausgabe = расходы, выпуск (газеты)
die Auster = устрица
der Eintritt = вход
die Ente = утка
krass = крутой, экстремальный (в разговорной речи)
fernen — gefernt = отдалять
hauen — gehauen = бить, колотить
die Forelle = форель
das Fraumünster = Фраумюнстер (церковь в Цюрихе)
das Gewölbe = кладовая
der Helikopter = вертолет =
der Hingucker = привлекательный объект, неотразимый взгляд
der Hinterhof = задний двор
hipp = современный (разг.)
der Hop = хмель
das Innendrin = внутри
der Jour = день (от французского)
das Kalb = теленок
das Kalbfleisch = телятина
der Kassensturz = пересчет (например, в кассе)
das Kreuz-und-Quer-Ticket = билет на путешествие по разным направлениям
die Kulinarik = кулинария
die Kutsche = карета, повозка
die Küste = побережье
die Nase = нос
die Orgel = орган (музыкальный инструмент)
die Panade = панировка
das Perfekt = перфект (грамматическое время)
das Pflaster = пластырь, мостовая
die Portion = порция
die Promenade = набережная, прогулочная улица
der Quatsch = ерунда, чепуха
der Reiseführer = путеводитель, экскурсовод
das Schweinefleisch = свинина
das Theater = театр
der Tscheche = чех
ungewohnt = непривычный, незнакомый
abseits = в стороне, вне (игры)
berühmt = знаменитый
die Uni = университет (разговорное)
die Versuchung = соблазн
die Vorsicht = осторожность
die Wurst = колбаса, сосиска
zeihen — geziehen = обвинять (устаревшее)
aufmachen — er macht auf — aufgemacht = открывать
ausmachen — er macht aus — ausgemacht = выключать
zumachen — er macht zu — zugemacht = закрывать
ausgeben — er gibt aus — ausgegeben — gab aus = тратить (деньги), выдавать
die Absprache = договоренность
absprechen sich — er spricht sich ab — abgesprochen = договариваться (с кем-то о чем-то)
die Vereinbarung = соглашение
vereinbaren — vereinbart = согласовывать
der Deal = сделка (разговорно)
einigen sich — geeinigt = прийти к согласию
charmant = обаятельный
dahinten = за этим
drunter = под этим
durchfuttern — er futtert durch — durchgefuttert = переедать
eingeben — er gibt ein — eingegeben — gab ein = вводить (данные, пароль), внушать
ernähren — ernährt = кормить
erwischen — erwischt = поймать, застать
flott = проворный, стильный (разг.)
goldig = прелестный (разг.)
gönnen — gegönnt = охотно позволять
hierfür = для сюда
hochgehen — ist hochgegangen — ging hoch = подниматься, выходить из себя (разг.)
kostenlos = бесплатно
köstlich = восхитительный
kulinarisch = кулинарный
lau = теплый, слабый
lokal = местный
lässig = расслабленный, стильный (разг.)
neugierig = любознательный
pur = чистый
mitfahren — er fährt mit — ist mitgefahren — fuhr mit = ехать с кем-то
reinsetzen sich — er setzt sich rein — reingesetzt — setzte sich rein = садиться внутрь
romantisch = романтичный
sensationell = сенсационный
touristisch = туристический
rüber = на ту сторону
stets = постоянно (статично)
v.a. — vor allem = прежде всего, главным образом
verstecken — versteckt = прятать
vorkommen — es kommt vor — ist vorgekommen — kam vor = происходить, случаться
wieso = почему, как так
wild = дикий
20er-Jahre = 20-е годы
24-h-Ticket = билет на 24 часа
der Abstecher = ответвление
die Achse = ось
der Anblick = взгляд
der Ansatz = подход
der Anstrich = покраска
der Aspekt = аспект
die Atmosphäre = атмосфера
die Attraktion = аттракцион
der Aufenthalt = пребывание
die Aufzucht = разведение молодняка
der Aufzug = лифт
der Ausgang = выход
der Aussichtspunkt = смотровая площадка
die Authentizität = подлинность
die Avantgarde = авангард, стремление к новаторству
die Bahngleise = железнодорожные пути
die Balance = баланс
die Bauarbeit = строительные работы
der Baumstamm = ствол дерева
die Begierde = страсть
die Begrüßung = приветствие
bereit = готовый
die Bezeichnung = наименование
die Berufsbezeichnung = наименование профессии
der Bescheid = уведомление
die Besonderheit = особенность
die Bibel = Библия, настольная книга
die Bierbrauerei = пивоварня
das Bierchen = пивко
die Bikinifigur = бикини фигура (хорошая физическая форма)
der Bildhauer = скульптор
die Bleibe = пристанище (жильё)
die Bohne = фасоль
das Boot = лодка =
der Boulevard = бульвар
die Broschüre = брошюра =
der Brösel = крошка
das Buntglasfenster = витраж
die Businessstadt = деловой город =
die Finanzstadt = финансовый город =
der Büchermarkt = книжный рынок =
der Charme = шарм
der Scheck = чек
die Dose = металлическая банка
der Drink = напиток
die Ecke; das Eckchen = угол; уголок
der Efeu = плющ
der Eiffelturm = Эйфелева башня
der Einheimische = местный житель
der Einkauf = покупка, шопинг
der Eintrittspreis = цена входного билета
das Eisbein = рулька (свиная)
der Eisenbahnbogen = железнодорожная арка
die Entdeckung = открытие
die Entschuldigung = извинение
erkennen — erkannt — erkannte = узнать, распознать
die Essensstraße = улица с едой
die Europastadt = европейский город
der Expressionist = экспрессионист (передача эмоций, а не действительности)
die Idylle = идиллия
das Fahrrad = велосипед = 
der Fahrradweg = велосипедная дорожка = 
die Familie = семья
die Fangfrische = свежий улов
das Fischlein = маленькая рыбка
die Fischstände = рыбные прилавки
die Fantasie = фантазия
die Faust = кулак
der Fernsehturm = телевизионная башня
der Fleck = пятно
die Folklore = фольклор
das Fotomotiv = фотографичное место
der Freizeitpark = парк развлечений
Freut mich = Приятно (познакомиться)
das Futter = корм
fressen — er frisst — hat gefressen — fraß = жрать
der Gang = проход
die Tipps = советы
die Gasse = переулок (небольшая улица, соединяющая 2 параллельные)
die Geburt = рождение
gehören — gehört = принадлежать { Dativ }
das Gemälde = картина
die Generationenfrage = вопрос поколений
der Genuss = наслаждение
der Geräuscheffekt = звуковой эффект
das Gesamterlebnis = общий опыт, полное переживание
das Geschnetzelte = мясное рагу
die Geste = жест
das Gewissen = совесть
das Glöckchen = колокольчик
die GmbH (Gesellschaft mit beschränkter Haftung) = общество с ограниченной ответственностью
die Gourmetstadt = город для гурманов
das Gourmet-Gemüse = изысканные овощи
das Graffiti = граффити =
die Grünflächen = зелёные зоны/территории
der Gruß = приветствие
das Hallöchen = приветик
der Hauptbestandteil = основной компонент
das Hauptwerk = главное произведение
die Heimreise = поездка домой
die Hitze = жара
der Hubschrauber = вертолет
der Heliport = вертолётная площадка
der Heli-Flug = полёт на вертолёте
Hereinspaziert! = Проходите!
herrlich = великолепный
die Hochhäuser = высотные здания
die Hölle = ад
das Image = имидж
das Imperium = империя
das In-Viertel = модный район
der Industriecharme = индустриальный шарм
der Inhaber = владелец
der Innenraum = внутреннее пространство
innovativ = инновационный
jawohl = да, точно
klassisch = классический
das Jh. = век
die Kanalisation = канализация
die Kapelle = капелла (хор)
die Karte = карта =
das Karussell = карусель
der Kasseler = кассель (вид мяса)
die Kategorie = категория
die Kathedrale = собор
das Kaufhaus = универмаг, торговый центр
der Kessel = котел
das Kinoerlebnis = киноопыт
der Kirchturm = церковная башня
das Klopfe = стук
der Klub = клуб
der Knaller = фейерверк, удар
die Kneipe = пивная
die Kneipentourum = тур по пивным
der Knurps = кошелек (старое слово)
das Krabbenfleisch = мясо креветок
die Krebsgaß = раковая дорожка
die Kreativität = креативность
das Kreuz = крест
die Kulturstiftung = культурный фонд
die Kunsthalle = художественная галерея
der Kunstliebhaber = любитель искусства
der Kunststil = стиль искусства
das Kunstzentrum = центр искусств
die Kuppel = купол
königlich = королевский
der Küss = поцелуй
das Küssche = поцелуйчик
das Ladenbauteil = компонент витрины
die Ladys = дамы
das Lammkotelett = котлета из баранины
die Lebensqualität = качество жизни
das Leid = страдание
der Leitspruch = девиз
die Liste = список =
die Mahlzeit = прием пищи
der Malzgeruch = запах солода
die Map = карта
der Marais = Маре (район в Париже)
die Markthalle = рыночный павильон
die Matratze = матрас
die Meeresfrucht = морепродукты
megagut = очень хорошо (разговорный)
das Meisterwerk = шедевр
das Minimum = минимум
die Mischung = смесь
das Mitbringsel = сувенир
das Mittagsschläfchen = послеобеденный сон
modern = современный
die Modernisme = модернизм
die Mongolei = Монголия
die Musikrichtung = музыкальный жанр
die Mühe = усилие
die Nachhaltigkeit = устойчивость
das Nachtleb = ночная жизнь
die Nahrung = питание
die Naschtour = гастрономический тур
die Nebensache = пустяк
die Nostalgie = ностальгия
die Oper = опера
die Opernballatmosphäre = атмосфера оперного бала
das Orchester = оркестр
der Orchestergraben = оркестровая яма
die Orientierung = ориентация
die Patisserie = кондитерская
das Pausenbrot = бутерброд для перекуса
der Performer = исполнитель
das Personal = персонал
der Pfarrer = священник
das Plopp = хлопок (звук)
das Plus = плюс
die Pracht = великолепие
der Probier = проба
die Probiertüte = пробный пакет
die Prägung = влияние, штамп
das Purgatoire = чистилище (место перед Раем, где души очищаются от грехов)
das Quartier = квартал
quasi = так сказать, как бы, почти
der Rang = ранг
der Rat = совет
die Rate = ставка, тариф
das Regal = полка
der Regen = дождь
die Regionalität = региональность
der Reingezoge = введение, вступление
der Bericht = отчет
die Reportage = репортаж
der Trend = тренд
das Ziel = цель
das Reißbrett = чертежная доска
relativ = относительно
das Rind = крупный рогатый скот
die Romantik = романтика
die Sahne = сливки
das Sandwich = сэндвич
das Schachbrettmuster = шахматный узор
die Schatzsuch = поиски сокровищ
die Scheibe = ломтик, стекло
die Scherenhände = руки как ножницы (отсылка к персонажу фильма)
die Schlange = змея
das Schlangestehen = стояние в очереди
der Schlemmer = гурман
der Schmetterling = бабочка
der Schnitt = разрез, стрижка, крой
das Schmuckstück = украшение
die Schnitzeljagd = охота за сокровищами
die Metropole = столица, центр
die Seerundfahrt = прогулка по озеру
die Sehenswürdigkeit = достопримечательность
die Semmelbrösel = панировочные сухари
die Showküche = кулинарное шоу
die Sommernacht = летняя ночь
die Sparfüchse = экономные лисы (экономные люди)
der Spaziergang = прогулка
die Speisekarte = меню
der Spiegel = зеркало
die Spraydose = баллончик с краской
der Spruch = поговорка, изречение
die Stadtbahn = городской трамвай
die Stadtführung = экскурсия по городу
die Stadtgrenze = граница города
die Stammkundschaft = постоянные клиенты
der Steinwurf = бросок камня
die Stellenanzeige = объявление о вакансии
das Sterne-Niveau = уровень звезд
der Stock = палка, этаж
der Stopp = остановка
der Store = магазин
die Straßenkunst = уличное искусство
reichen — gereicht = подавать, быть достаточным
runterkommen — er kommt runter — ist runtergekommen — kam runter = спуститься, опуститься (морально)
runter = вниз
schlicht = простой
der Stummfilm = немое кино
die Summe = сумма
die Säule = колонна
die Tageszeit = время суток
der Onkel = дядя
die Tante = тётя
die Tasche = сумка
das Theaterstück = пьеса
der Tintenfisch = кальмар
der Topf = горшок, кастрюля
der Trüffel = трюфель
die Unterführung = подземный переход
die Unterkunft = жильё, размещение
der Untertitel = субтитры
der Urgroßvater = прадедушка
der Vegetarier = вегетарианец
das Verhältnis = отношение, соотношение
der Vertreter = представитель
der Videoprojektor = видеопроектор
der Weitblick = дальновидность
der Weltrekord = мировой рекорд
die Wetterlage = погодные условия
der Winkel = угол
der Wolkenkratzer = небоскрёб
der Wurlitzer = Вурлицер (марка музыкальных автоматов)
der Zeltplatz = кемпинг
der Zwischenstand = промежуточный результат
der Geschmack = вкус
der Rummel = шум, суета
das Trüffelschwein = свинья, ищущая трюфели
die Zwiebel = лук
Zugewanderte, Ausländer, Kanake = приезжий, иностранец, "чурка"
treiben — getrieben — trieb = гнать, заниматься (спортом)
abnehmen — er nimmt ab — abgenommen — nahm ab = худеть, снимать
zunehmen — er nimmt zu — zugenommen — nahm zu = поправляться
abonnieren — abonniert = подписываться
abschauen — er schaut ab — abgeschaut = подсматривать
abschlagen — er schlägt ab — abgeschlagen — schlug ab = отбивать, отказывать
anlehnen an { Akkusativ } — er lehnt an — angelehnt = прислонять к { чему? }
antun — er tut an — angetan — tat an = причинять, делать (кому-то)
aufstehen — er steht auf — ist aufgestanden — stand auf = вставать
ausklingen — es klingt aus — ist ausgeklungen — klang aus = завершаться (о мероприятии)
ausnutzen — er nutzt aus — ausgenutzt = использовать в своих целях
ausschenken — er schenkt aus — ausgeschenkt = разливать напитки
bedanken sich bei { Dativ } für { Akkusativ } — bedankt = благодарить { кого? } за { что? }
aushalten — er hält aus — ausgehalten — hielt aus = выдерживать
ausbacken — er bäckt aus — ausgebacken — backte aus = дожаривать
austoben sich — er tobt sich aus — ausgetobt = выплеснуть энергию
benachrichtigen — er benachrichtigt — benachrichtigt = уведомлять
zusammenkommen mit { Dativ } — er kommt zusammen — ist zusammengekommen — kam zusammen = встречаться с { кем? }
zuschauen — er schaut zu — zugeschaut = наблюдать
aufpeppen — er peppt auf — aufgepeppt = оживлять, модернизировать
aufsteigen — er steigt auf — ist aufgestiegen — stieg auf = подниматься
ausprägen — er prägt aus — ausgeprägt = выражать, чеканить
beklemmen — beklemmt = угнетать
anfühlen sich — er fühlt sich an — angefühlt = ощущаться
aussehen — es sieht aus — ausgesehen — sah aus = выглядеть
anfragen — er fragt an — angefragt = запрашивать
angucken — er guckt an — hat angeguckt — guckte an = смотреть
zentral = центральный
abwechslungsreich = разнообразный
autofrei = свободный от автомобилей
avantgardistisch = авангардный
superlativ = превосходный
superlecker = очень вкусный
superpreis = суперцена
toll = классный
touristenmagnet = привлекающий туристов
trachtig = традиционный (в плане одежды)
traditionshaus = традиционное заведение
vegetarisch = вегетарианский
vortags = предшествующий дню
z.T. — zum Teil = частичный
attraktiv = привлекательный
beherzt = смелый, отважный
angeblich = якобы
anscheinend = по-видимому
all-inclusive = всё включено
allerliebst = очаровательный
das Verhalten = поведение
das Benehmen = поведение
benehmen sich — er benimmt sich — benommen — benahm sich = вести себя
die Lampe = лампа
der Lauf = бег, ход
besteigen — bestiegen — bestieg = восходить, подниматься
bestätigen — bestätigt = подтверждать
bewachsen — er bewächst — bewachsen — bewuchs = зарастать
bezeichnen als { Akkusativ } — bezeichnet = обозначать как { что? }
brauen — gebraut = варить (пиво)
brummen — gebrummt = гудеть, ворчать
drehen — gedreht = поворачивать, крутить
durchfrittieren — er frittiert durch — durchfrittiert = прожаривать
durchprobieren — er probiert durch — durchprobiert = перепробовать
einbauen — er baut ein — eingebaut = встраивать
einbeziehen in { Akkusativ } — er bezieht ein — einbezogen — bezog ein = включать в { что? }
einchecken — er checkt ein — eingecheckt = регистрироваться (в отеле, аэропорту)
einfallen — er fällt ein — ist eingefallen — fiel ein = приходить в голову
einlassen sich auf { Akkusativ } — er lässt sich ein — eingelassen — ließ sich ein = ввязываться в { что? }
einsteigen in { Akkusativ } — er steigt ein — ist eingestiegen — stieg ein = входить (в транспорт)
entgehen — ist entgangen — entging = избегать, ускользать
erwachen — er erwacht — ist erwacht = пробуждаться
existieren — existiert = существовать
fabrizieren — fabriziert = производить
fehlen — gefehlt = отсутствовать, недоставать
folgen { Dativ } — ist gefolgt — folgte = следовать за { кем? чем? }
hineinziehen in { Akkusativ } — er zieht hinein — hineingezogen — zog hinein = втягивать в { что? }
hinzugeben — er gibt hinzu — hinzugegeben — gab hinzu = добавлять
hochfahren — er fährt hoch — ist hochgefahren — fuhr hoch = загружать (компьютер), подниматься
informieren über { Akkusativ } — informiert = информировать о { чём? }
klettern auf { Akkusativ } — ist geklettert = карабкаться на { что? }
knabbern — geknabbert = грызть
lachen über { Akkusativ } — gelacht = смеяться над { чем? }
lauten — gelautet = звучать
herführen — er führt her — hergeführt = приводить (сюда)
hochbauen — er baut hoch — hochgebaut = строить высоко
kaputtgehen — er geht kaputt — ist kaputtgegangen — ging kaputt = ломаться
kriegen — gekriegt = получать
benommen = ошеломлённый
biblisch = библейский
fortschrittlich = прогрессивный
frisch = свежий
fündig = богатый (полезными ископаемыми)
bildend = образовательный
biologisch = биологический
bunt = разноцветный
ca. — circa = примерно
donnerstags = по четвергам
durchsichtig = прозрачный
dörflich = деревенский
edel = благородный
eindeutig = однозначный
einmalig = уникальный
erholsam = расслабляющий
erkennbar = различимый
erwachsen = взрослый
farbig = цветной
faul = ленивый, гнилой
fettig = жирный
fließend = плавный, беглый (о речи)
folkloristisch = фольклорный
fremd = чужой, иностранный
futuristisch = футуристический
gewiss = определённый, несомненный
goldgelb = золотисто-жёлтый
großzügig = щедрый
hauchdünn = тончайший
jeweils = соответственно
kerzengerade = прямой, как свеча
kitschig = безвкусный (в искусстве)
knusprig = хрустящий
krass = резкий, крутой
lebenswert = достойный жизни
leise = тихий
die Suppe = суп
das Plätzchen = печенье, лепёшка
die Portion = порция
das Superwetter = отличная погода
locken — gelockt = привлекать, завлекать
mitbringen — mitgebracht — brachte mit = приносить с собой
mitfahren — er fährt mit — ist mitgefahren — fuhr mit = ехать вместе
packen — gepackt = упаковывать
räuspern sich — er räuspert sich — geräuspert = откашливаться
rüberkommen — er kommt rüber — ist rübergekommen — kam rüber = производить впечатление, переходить
schlagen — er schlägt — geschlagen — schlug = бить, взбивать
schlemmen — geschlemmt = лакомиться
schmieren — geschmiert = мазать
schwenken — geschwenkt = махать, поворачивать
Ski fahren — er fährt Ski — ist Ski gefahren — fuhr Ski = кататься на лыжах
summen — gesummt = жужжать, напевать
pressen — gepresst = давить, сжимать
prägen — geprägt = формировать, чеканить
raten — er rät — geraten — riet = советовать, угадывать
rausnehmen — er nimmt raus — rausgenommen — nahm raus = вынимать
regnen — es regnet — geregnet = идти (о дожде)
reifen — ist gereift = созревать
reinfallen auf { Akkusativ } — er fällt rein — ist reingefallen — fiel rein = попадаться на { что? }
runterladen — er lädt runter — runtergeladen — lud runter = скачивать
runtergucken — er guckt runter — hat runtergeguckt = смотреть вниз
runterspülen — er spült runter — hat runtergespült = запивать
schmecken nach { Dativ } — geschmeckt = иметь вкус { чего? }
schweben — geschwebt = парить
sprengen — gesprengt = взрывать
stärken — gestärkt = укреплять
tauchen — ist getaucht = нырять
umfunktionieren — er funktioniert um — umfunktioniert = переоборудовать
verankern — verankert = закреплять
luxuriös = роскошный
mediterran = средиземноморский
megagut = очень хороший
moderat = умеренный
mächtig = мощный
nacheinander = один за другим
miteinander = друг с другом
neigen zu { Dativ } = склонный к { чему? }
niedlich = милый
nochmal = снова
nostalgisch = ностальгический
obendrauf = сверху
optisch = визуальный
ordentlich = аккуратный
original = оригинальный
pfiffig = находчивый
philosophisch = философский
populär = популярный
gerecht = справедливый
preiswert = недорогой
provinziell = провинциальный
quadratisch = квадратный
rasant = стремительный
rechts = справа
rum, herum = вокруг
rundherum = со всех сторон
saisonal = сезонный
schlicht = простой
somit = таким образом
soweit = насколько
spirituell = духовный
sprachlos = потерявший дар речи
stattdessen = вместо этого
stattlich = представительный
staunend = изумлённый
sämtlich = все без исключения
tagesfrisch = свежий (на день)
teuer = дорогой
traditionell = традиционный
trubelig = шумный
ultimativ = окончательный
umfassend = обширный
unheimlich = жуткий, невероятно
unromantisch = не романтичный
unschlagbar = непревзойдённый
unsicher = неуверенный
unspektakulär = не зрелищный
untypisch = нетипичный
unvergesslich = незабываемый
unverwechselbar = неповторимый
unvorstellbar = немыслимый
uralt = древний
der Überblick = обзор
die Überzeugung = убеждение
verewigen — verewigt = увековечивать
vergehen — ist vergangen — verging = проходить (о времени)
verlaufen sich — er verläuft sich — verlaufen — verlief sich = заблудиться
verleihen — verliehen — verlieh = одалживать, присуждать (награду)
versprechen — er verspricht — versprochen — versprach = обещать
verzieren — verziert = украшать
verzweigen sich — verzweigt = разветвляться
vorbeikommen — er kommt vorbei — ist vorbeigekommen — kam vorbei = заходить мимоходом
wenden — gewendet = поворачивать
wiederverkaufen — er verkauft wieder — wiederverkauft = перепродавать
einwilligen in { Akkusativ } — er willigt ein — eingewilligt = соглашаться на { что? }
zugreifen — er greift zu — zugegriffen — griff zu = хватать, воспользоваться шансом
zukommen auf { Akkusativ } — er kommt zu — ist zugekommen — kam zu = подходить к { кому? }
zusammensitzen — er sitzt zusammen — zusammengesessen — saß zusammen = сидеть вместе
übergehen zu { Dativ } — er geht über — ist übergegangen — ging über = переходить к { чему? }
übernachten — übernachtet = ночевать
überragen — überragt = возвышаться
verlocken — verlockt = заманивать
vermuten — vermutet = предполагать
verschwimmen — ist verschwommen — verschwamm = размываться
veräppeln — veräppelt = подшучивать, разыгрывать
vorbehalten — er behält vor — vorbehalten — behielt vor = оставлять за собой право
zufriedengeben sich mit { Dativ } — er gibt sich zufrieden — zufriedengegeben — gab sich zufrieden = довольствоваться { чем? }
überliegen — überlegen — überlag = находиться сверху
überliefern — überliefert = передавать (из поколения в поколение)
verfügbar = доступный
verschwenderisch = расточительный
vielseitig = разносторонний
vollständig = полный, завершённый
vorab = заранее
weltberühmt = всемирно известный
weltoffen = открытый миру
wollüstig = сладострастный
zweitgrößter = второй по величине
zweitteuer = второй по дороговизне
zwischendurch = между делом
essbar = съедобный
ästhetisch = эстетичный
überirdisch = неземной
überraschend = неожиданный
überschaubar = обозримый
